flaeche_km2,pop_insgesamt,pop_maennlich,pop_weiblich,pop_density,stadt_name
891.12,3782202,1860115,1922087,4244,Berlin
755.09,1910160,936740,973420,2530,Hamburg
310.7,1510378,734925,775453,4861,München
405.02,1087353,527728,559625,2685,Köln
248.31,775790,382226,393564,3124,Frankfurt am Main
207.33,633484,316030,317454,3055,Stuttgart
217.41,631217,304616,326601,2903,Düsseldorf
297.8,619879,305443,314436,2082,Leipzig
280.71,595471,292178,303293,2121,Dortmund
210.34,586608,285411,301197,2789,Essen
318.2,577026,285270,291756,1813,Bremen
328.48,566222,281215,285007,1724,Dresden
204.3,548186,268214,279972,2683,Hannover
186.44,526091,257320,268771,2822,Nürnberg
232.84,503707,249120,254587,2163,Duisburg
145.66,366385,178896,187489,2515,Bochum
168.39,358938,176056,182882,2132,Wuppertal
258.83,338410,163288,175122,1307,Bielefeld
141.06,335789,160546,175243,2380,Bonn
303.28,322904,155052,167852,1065,Münster
144.97,316877,158281,158596,2186,Mannheim
173.42,309964,158520,151444,1787,Karlsruhe
146.85,303150,149531,153619,2064,Augsburg
203.87,285522,136598,148924,1401,Wiesbaden
170.47,268943,133625,135318,1578,Mönchengladbach
104.94,265885,132249,133636,2534,Gelsenkirchen
160.85,252769,132027,120742,1571,Aachen
192.7,252066,124898,127168,1308,Braunschweig
221.03,250681,123838,126843,1134,Chemnitz
118.65,248873,120699,128174,2098,Kiel
135.56,242172,117365,124807,1786,Halle (Saale)
201.68,240114,118654,121460,1191,Magdeburg
153.04,237244,112660,124584,1550,Freiburg im Breisgau
137.77,228550,111419,117131,1659,Krefeld
97.73,222889,108873,114016,2281,Mainz
214.19,219044,105259,113785,1023,Lübeck
269.91,215675,104791,110884,799,Erfurt
77.09,211099,103059,108040,2738,Oberhausen
181.36,210795,103349,107446,1162,Rostock
106.79,204687,100203,104484,1917,Kassel
160.45,190490,93469,97021,1187,Hagen
188.24,187119,90107,97012,994,Potsdam
167.52,183509,91475,92034,1095,Saarbrücken
226.66,180761,89286,91475,797,Hamm
77.43,176110,88552,87558,2274,Ludwigshafen am Rhein
103.09,174629,83608,91021,1694,Oldenburg (Oldenburg)
91.28,173255,83637,89618,1898,Mülheim an der Ruhr
119.8,166960,80585,86375,1394,Osnabrück
78.87,166414,81121,85293,2110,Leverkusen
122.07,164792,84206,80586,1350,Darmstadt
108.83,162960,77929,85031,1497,Heidelberg
89.54,161545,78754,82791,1804,Solingen
80.86,159465,78024,81441,1972,Regensburg
51.42,157896,77401,80495,3071,Herne
179.59,155749,77843,77906,867,Paderborn
99.52,155163,75336,79827,1559,Neuss
133.35,142308,72076,70232,1067,Ingolstadt
44.88,135490,67279,68211,3019,Offenbach am Main
63.35,132032,64793,67239,2084,Fürth
99.89,130093,65794,64299,1302,Heilbronn
118.68,129942,64384,65558,1095,Ulm
97.99,128992,63717,65275,1316,Pforzheim
87.6,128246,61560,66686,1464,Würzburg
204.62,127256,63352,63904,622,Wolfsburg
117.02,120261,58433,61828,1028,Göttingen
100.61,118705,57841,60864,1180,Bottrop
87.04,118528,58803,59725,1362,Reutlingen
76.96,117806,58694,59112,1531,Erlangen
105.25,115298,56682,58616,1095,Koblenz
101.41,114677,56716,57961,1131,Bremerhaven
74.52,112970,56058,56912,1516,Remscheid
117.06,112737,55783,56954,963,Trier
83.09,112660,53929,58731,1356,Bergisch Gladbach
66.5,111693,54223,57470,1680,Recklinghausen
114.77,110791,55060,55731,965,Jena
67.64,105606,51248,54358,1561,Moers
224.49,105039,52386,52653,468,Salzgitter
76.28,103184,50927,52257,1353,Hanau
112.02,102464,50733,51731,915,Gütersloh
92.29,102325,48866,53459,1109,Hildesheim
114.69,102114,50110,52004,890,Siegen
139.7,101486,51241,50245,726,Kaiserslautern
165.61,100010,48883,51127,604,Cottbus/Chóśebuz
130.52,98733,47339,51394,756,Schwerin
46.43,95881,48521,47360,2065,Esslingen am Neckar
72.4,95724,46540,49184,1322,Witten
72.61,94996,46730,48266,1308,Gießen
43.34,94859,46775,48084,2189,Ludwigsburg
152.18,94847,45922,48925,623,Gera
108.07,93615,44250,49365,866,Tübingen
85.01,93323,46221,47102,1098,Düren
56.73,92667,45905,46762,1633,Flensburg
125.49,92404,45063,47341,736,Iserlohn
165.53,89145,43827,45318,539,Villingen-Schwenningen
102.58,87593,42936,44657,854,Zwickau
88.74,87513,42309,45204,986,Ratingen
59.39,87266,42512,44754,1469,Lünen
54.12,85770,40910,44860,1585,Konstanz
108.73,85609,42650,42959,787,Worms
87.76,85001,41621,43380,969,Marl
101.12,83100,40938,42162,822,Minden
58.1,82719,40260,42459,1424,Norderstedt
74.9,82462,40423,42039,1101,Velbert
54.62,80580,39589,40991,1475,Bamberg
71.66,80185,39772,40413,1119,Neumünster
245.78,79686,38528,41158,324,Dessau-Roßlau
91.1,79250,38609,40641,870,Viersen
62.45,78979,38984,39995,1265,Delmenhorst
145.0,78220,38599,39621,539,Rheine
123.91,78203,36852,41351,631,Marburg
70.5,77511,37099,40412,1099,Lüneburg
171.2,76842,37356,39486,449,Dorsten
62.0,76503,37608,38895,1234,Troisdorf
107.11,76247,37481,38766,712,Wilhelmshaven
35.97,75799,36883,38916,2107,Gladbeck
65.83,75272,36756,38516,1143,Landshut
66.89,74907,36670,38237,1120,Bayreuth
129.39,74835,36108,38727,578,Detmold
51.68,74370,36409,37961,1439,Castrop-Rauxel
193.72,74206,36458,37748,383,Arnsberg
229.73,73921,36286,37635,322,Brandenburg an der Havel
62.45,72918,35432,37486,1168,Aschaffenburg
119.4,72409,35603,36806,606,Bocholt
87.02,71463,35125,36338,821,Lüdenscheid
63.28,70713,35028,35685,1117,Kempten (Allgäu)
104.05,70366,34810,35556,676,Fulda
176.02,70293,34005,36288,399,Celle
146.58,69147,34458,34689,472,Aalen
113.68,69047,34046,35001,607,Lippstadt
47.66,67949,32750,35199,1426,Dinslaken
58.29,67656,33895,33761,1161,Rüsselsheim am Main
113.96,67627,33332,34295,593,Kerpen
79.15,67265,33011,34254,850,Herford
86.5,66243,32664,33579,766,Neuwied
84.47,65611,31599,34012,777,Weimar
50.83,65504,32668,32836,1289,Sindelfingen
102.11,65218,31970,33248,639,Plauen
37.22,65192,32453,32739,1752,Rosenheim
85.5,65170,32435,32735,762,Dormagen
102.52,64588,31179,33409,630,Grevenbroich
86.12,64390,31154,33236,748,Neubrandenburg
69.93,63441,31422,32019,907,Friedrichshafen
113.81,62726,30575,32151,551,Schwäbisch Gmünd
37.33,62204,30351,31853,1666,Herten
78.37,62195,30807,31388,794,Offenburg
96.34,62172,30305,31867,645,Bergheim
80.95,61780,30663,31117,763,Neu-Ulm
79.49,61594,30032,31562,775,Garbsen
122.56,61277,29776,31501,500,Wesel
51.22,61252,29876,31376,1196,Hürth
139.49,60256,29737,30519,432,Euskirchen
88.56,60223,29278,30945,680,Unna
50.81,60071,28501,31570,1182,Greifswald
41.15,59908,29103,30805,1456,Langenfeld (Rheinland)
54.59,59450,28865,30585,1089,Stralsund
59.21,59300,29501,29799,1002,Göppingen
147.85,58818,28657,30161,398,Frankfurt (Oder)
102.53,57916,27702,30214,565,Hameln
64.4,57440,27562,29878,892,Meerbusch
140.19,57420,27501,29919,410,Baden-Baden
176.19,57075,28507,28568,324,Lingen (Ems)
67.53,56694,27284,29410,840,Görlitz
34.22,56692,27764,28928,1657,Sankt Augustin
98.48,56584,27954,28630,575,Stolberg (Rhld.)
72.15,56284,27201,29083,780,Pulheim
75.75,56132,27589,28543,741,Eschweiler
51.14,55995,26558,29437,1095,Bad Homburg v. d. Höhe
42.75,55917,27369,28548,1308,Waiblingen
71.97,55746,27551,28195,775,Langenhagen
25.95,55689,26861,28828,2146,Hilden
149.86,55619,27426,28193,371,Nordhorn
35.7,55067,27308,27759,1542,Schweinfurt
75.65,54629,26517,28112,722,Wetzlar
71.67,54620,26519,28101,762,Hattingen
100.05,54585,26388,28197,546,Bad Salzuflen
69.56,54401,26467,27934,782,Passau
117.09,53920,26353,27567,461,Neustadt an der Weinstraße
97.76,53458,26550,26908,547,Kleve
123.13,53278,26030,27248,433,Ahlen
45.06,53128,25954,27174,1179,Frechen
78.74,53034,26166,26868,674,Wolfenbüttel
55.56,52989,25315,27674,954,Bad Kreuznach
108.87,52688,26068,26620,484,Ibbenbüren
86.1,52177,25478,26699,606,Menden (Sauerland)
39.04,52093,25834,26259,1334,Böblingen
95.41,51845,25564,26281,543,Gummersbach
58.98,51800,25947,25853,878,Rastatt
92.05,51788,25920,25868,563,Ravensburg
119.84,51521,25482,26039,430,Peine
42.71,51203,24998,26205,1199,Speyer
21.36,50728,24907,25821,2375,Elmshorn
39.37,50670,24746,25924,1287,Lörrach
112.34,50659,25242,25417,451,Emden
163.88,50253,24592,25661,307,Goslar
67.8,50212,24605,25607,741,Willich
78.82,50151,25126,25025,636,Gronau (Westf.)
119.89,50018,24230,25788,417,Erftstadt
88.59,49939,25165,24774,564,Freising
107.09,49895,24928,24967,466,Heidenheim an der Brenz
86.72,49849,24930,24919,575,Rheda-Wiedenbrück
48.73,49845,24864,24981,1023,Leonberg
67.59,49775,25214,24561,736,Straubing
64.83,49566,24345,25221,765,Bad Oeynhausen
61.77,49518,24134,25384,802,Singen (Hohentwiel)
44.9,49475,24606,24869,1102,Bergkamen
69.84,49420,24807,24613,708,Lahr/Schwarzwald
43.88,49122,24061,25061,1119,Frankenthal (Pfalz)
82.69,49074,23918,25156,593,Bornheim
161.93,48713,23119,25594,301,Cuxhaven
110.07,48708,23767,24941,443,Stade
31.68,48518,24062,24456,1532,Alsdorf
163.69,48492,23665,24827,296,Oranienburg
82.94,48341,23072,25269,583,Landau in der Pfalz
34.96,48337,23675,24662,1383,Dachau
85.81,48250,23492,24758,562,Soest
105.89,48190,23403,24787,455,Hennef (Sieg)
184.83,47937,23457,24480,259,Dülmen
253.95,47387,23564,23823,187,Melle
45.34,47241,22908,24333,1042,Oberursel (Taunus)
75.26,47097,23178,23919,626,Neunkirchen
33.38,47071,22827,24244,1410,Herzogenrath
93.04,47014,23693,23321,505,Bruchsal
58.02,46963,22880,24083,809,Hof
134.4,46831,23278,23553,348,Albstadt
65.04,46683,23229,23454,718,Rodgau
56.23,46571,22928,23643,828,Schwerte
40.02,46386,22925,23461,1159,Kaufbeuren
69.58,46300,22783,23517,665,Gotha
38.55,46295,22972,23323,1201,Filderstadt
27.71,46205,22498,23707,1667,Fellbach
70.11,46178,22848,23330,659,Memmingen
59.3,45891,22333,23558,774,Bünde
241.77,45588,22091,23497,189,Wittenberg
36.12,45515,21670,23845,1260,Brühl
58.11,45381,22073,23308,781,Weinheim
358.96,45325,22450,22875,126,Neustadt am Rübenberge
127.67,45097,22516,22581,353,Lehrte
43.34,45005,22083,22922,1038,Falkensee
142.27,44791,22173,22618,315,Rottenburg am Neckar
21.54,44756,21967,22789,2078,Pinneberg
117.34,44572,21836,22736,380,Erkelenz
104.19,44254,21422,22832,425,Bernau bei Berlin
37.39,44208,21153,23055,1182,Kaarst
41.73,44022,21256,22766,1055,Wismar
105.39,43941,21621,22320,417,Gifhorn
31.29,43808,21524,22284,1400,Bietigheim-Bissingen
26.88,43801,20976,22825,1630,Erkrath
92.21,43620,21576,22044,473,Heinsberg
153.24,43589,21513,22076,284,Borken
23.05,43524,20992,22532,1888,Monheim am Rhein
83.87,43425,21396,22029,518,Nettetal
197.29,43375,21461,21914,220,Aurich
70.57,43188,20955,22233,612,Weiden i.d.OPf.
40.95,43001,21060,21941,1050,Kamen
104.17,42817,21168,21649,411,Eisenach
104.19,42743,20927,21816,410,Schwäbisch Hall
50.14,42676,21100,21576,851,Amberg
34.16,42560,20432,22128,1246,Laatzen
82.61,42498,20751,21747,514,Homburg
53.27,42389,20916,21473,796,Dreieich
99.91,42311,20297,22014,423,Ansbach
40.47,42178,20854,21324,1042,Kirchheim unter Teck
48.29,42139,20616,21523,873,Coburg
23.66,42025,20669,21356,1776,Siegburg
21.61,41822,20347,21475,1935,Germering
57.83,41758,20526,21232,722,Bensheim
93.63,41704,20357,21347,445,Eberswalde
125.74,41666,20278,21388,331,Wunstorf
76.2,41642,20249,21393,546,Königswinter
61.27,41594,20544,21050,679,Hückelhoven
46.88,41447,20658,20789,884,Nürtingen
40.8,41380,20296,21084,1014,Schwabach
74.76,41290,19880,21410,552,Buchholz in der Nordheide
76.69,41256,20413,20843,538,Buxtehude
79.01,41255,20356,20899,522,Neumarkt i.d.OPf.
108.24,41233,20327,20906,381,Nordhausen
48.31,41045,20683,20362,850,Freiberg
61.35,40941,20076,20865,667,Pirmasens
56.83,40614,20060,20554,715,Schorndorf
151.24,40580,20313,20267,268,Ahaus
100.85,40531,20014,20517,402,Lemgo
29.89,40526,20024,20502,1356,Leinfelden-Echterdingen
57.43,40412,19733,20679,704,Hofheim am Taunus
67.1,40358,19729,20629,601,Völklingen
59.51,40162,19711,20451,675,Löhne
143.27,40069,20226,19843,280,Halberstadt
29.12,40009,19714,20295,1374,Langen (Hessen)
22.81,39833,19708,20125,1746,Ostfildern
56.75,39763,19326,20437,701,Ettlingen
32.41,39698,19586,20112,1225,Maintal
40.46,39477,19229,20248,976,Freital
35.79,39424,19464,19960,1102,Niederkassel
24.29,39420,19349,20071,1623,Neu-Isenburg
53.06,39303,19050,20253,741,Pirna
42.56,39197,18844,20353,921,Mettmann
113.96,39181,19310,19871,344,Weißenfels
198.69,39147,20192,18955,197,Ilmenau
96.04,39096,19205,19891,407,Königs Wusterhausen
269.24,38946,18880,20066,145,Stendal
118.44,38841,19746,19095,328,Papenburg
34.39,38750,18926,19824,1127,Würselen
63.14,38731,19009,19722,613,Kamp-Lintfort
75.07,38721,19258,19463,516,Kehl
23.37,38355,18979,19376,1641,Wesseling
140.26,38321,18837,19484,273,Greven
32.52,38187,18645,19542,1174,Fürstenfeldbruck
39.38,38184,19104,19080,970,Backnang
66.67,38039,18518,19521,571,Bautzen / Budyšin
159.03,38033,18427,19606,239,Haltern am See
87.23,37850,18473,19377,434,Bitterfeld-Wolfen
176.88,37847,18471,19376,214,Warendorf
90.45,37784,19008,18776,418,Tuttlingen
111.46,37452,18560,18892,336,Beckum
70.86,37280,18436,18844,526,Cloppenburg
141.36,37259,18415,18844,264,Coesfeld
54.61,37169,17972,19197,681,Erding
141.62,36986,18488,18498,261,Suhl
126.99,36978,18345,18633,291,Sinsheim
135.52,36641,17804,18837,270,Mühlhausen/Thüringen
72.06,36556,18115,18441,507,Emsdetten
45.16,36506,18055,18451,808,Limburg a. d. Lahn
109.77,36499,17951,18548,333,Winsen (Luhe)
73.31,36390,17873,18517,496,Ingelheim am Rhein
105.22,36300,18155,18145,345,Porta Westfalica
53.49,36282,17829,18453,678,Voerde (Niederrhein)
109.08,36239,18418,17821,332,Crailsheim
188.4,36137,18015,18122,192,Meppen
25.68,36021,17621,18400,1403,Bad Vilbel
77.14,35757,18294,17463,464,Deggendorf
115.43,35520,17790,17730,308,Goch
111.67,35456,17670,17786,318,Steinfurt
44.13,35359,17947,17412,801,Mörfelden-Walldorf
76.04,35311,17337,17974,464,Lage
21.68,35268,17532,17736,1627,Dietzenbach
66.1,35200,17227,17973,533,Datteln
70.11,35163,17110,18053,502,Leer (Ostfriesland)
49.95,35059,16895,18164,702,St. Ingbert
90.32,35054,17120,17934,388,Balingen
102.81,34955,17261,17694,340,Barsinghausen
43.3,34893,16856,18037,806,Saarlouis
68.8,34888,16898,17990,507,Kempen
54.08,34798,17220,17578,643,Seelze
53.87,34721,17053,17668,645,Merseburg
74.8,34673,16870,17803,464,Wermelskirchen
33.81,34617,16757,17860,1024,Wedel
70.64,34613,17203,17410,490,Zweibrücken
96.97,34604,17334,17270,357,Geldern
35.29,34601,16433,18168,980,Ahrensburg
48.41,34348,16846,17502,710,Viernheim
72.15,34331,16906,17425,476,Biberach an der Riß
55.24,34324,16688,17636,621,Korschenbroich
14.65,34177,16825,17352,2333,Kornwestheim
87.89,34145,17010,17135,388,Vechta
136.84,33991,16472,17519,248,Uelzen
67.66,33916,16816,17100,501,Hemer
62.84,33849,16704,17145,539,Rheinfelden (Baden)
32.54,33809,16042,17767,1039,Bad Nauheim
26.14,33804,16322,17482,1293,Radebeul
360.74,33635,16248,17387,93,Schwedt/Oder
44.44,33610,16410,17200,756,Forchheim
90.39,33359,16767,16592,369,Jülich
72.27,33053,16433,16620,457,Lampertheim
65.7,32961,16173,16788,502,Herrenberg
68.06,32961,16040,16921,484,Achim
157.28,32874,16706,16168,209,Delbrück
70.67,32763,16242,16521,464,Fürstenwalde/Spree
33.25,32763,16212,16551,985,Geesthacht
58.55,32575,15679,16896,556,Radolfzell am Bodensee
64.53,32423,15689,16734,502,Nienburg (Weser)
130.25,32336,15683,16653,248,Naumburg (Saale)
28.54,32319,15545,16774,1132,Itzehoe
80.4,32157,16149,16008,400,Emmerich am Rhein
113.92,32106,15530,16576,282,Bernburg (Saale)
55.49,32022,15696,16326,577,Georgsmarienhütte
170.5,31943,15289,16654,187,Wernigerode
38.66,31918,15585,16333,826,Oer-Erkenschwick
305.19,31803,15578,16225,104,Neuruppin
183.39,31801,16243,15558,173,Bramsche
356.56,31713,15402,16311,89,Geestland
45.69,31580,15140,16440,691,Altenburg
94.99,31404,15158,16246,331,Hoyerswerda / Wojerecy
112.56,31302,15247,16055,278,Burgdorf
71.07,31251,15409,15842,440,Kreuztal
26.34,31198,15198,16000,1184,Gevelsberg
50.18,31131,15745,15386,620,Friedberg (Hessen)
75.24,31096,15222,15874,413,Rheinberg
19.46,31065,15131,15934,1596,Weil am Rhein
76.35,30938,15802,15136,405,Werl
65.62,30894,15085,15809,471,Lohmar
336.46,30890,15251,15639,92,Walsrode
81.29,30881,15525,15356,380,Neuburg a.d.Donau
67.02,30820,14900,15920,460,Taunusstein
73.87,30770,15098,15672,417,Bad Hersfeld
231.92,30725,15021,15704,132,Einbeck
147.17,30717,14960,15757,209,Osterholz-Scharmbeck
81.25,30670,15049,15621,377,Friedberg
24.19,30558,14627,15931,1263,Haan
23.75,30545,15548,14997,1286,Rendsburg
57.77,30502,14836,15666,528,Ennepetal
110.31,30461,15375,15086,276,Rietberg
53.34,30408,14811,15597,570,Andernach
86.52,30402,14819,15583,351,Schönebeck (Elbe)
123.8,30239,15101,15138,244,Schwandorf
65.01,30190,14902,15288,464,Gaggenau
71.1,30136,14994,15142,424,Bretten
108.98,30070,15051,15019,276,Merzig
218.52,29988,14953,15035,137,Meschede
76.14,29868,14413,15455,392,Werne
102.77,29783,14874,14909,290,Oelde
57.9,29739,14842,14897,514,Landsberg am Lech
14.93,29661,14991,14670,1987,Unterschleißheim
47.09,29586,14282,15304,628,Waltrop
71.09,29582,14341,15241,416,Güstrow
20.67,29452,14709,14743,1425,Mühlheim am Main
109.99,29441,14564,14877,268,Ludwigsfelde
28.05,29436,14494,14942,1049,Winnenden
73.4,29387,14608,14779,400,Vaihingen an der Enz
145.85,29337,14326,15011,201,Northeim
44.34,29331,14479,14852,662,Tönisvorst
75.83,29261,14813,14448,386,Geislingen an der Steige
160.13,29258,14202,15056,183,Springe
73.18,29214,14348,14866,399,Bühl
38.8,29206,14279,14927,753,Rösrath
91.58,29158,14264,14894,318,Idar-Oberstein
58.91,29127,14011,15116,494,Riesa
145.56,29121,14174,14947,200,Saalfeld/Saale
30.73,29106,14224,14882,947,Kelkheim (Taunus)
30.92,29051,13924,15127,940,Meißen
33.78,29035,14071,14964,860,Emmendingen
136.48,28900,14371,14529,212,Mechernich
29.99,28835,14082,14753,961,Rödermark
158.16,28749,14231,14518,182,Höxter
15.8,28720,14326,14394,1818,Hattersheim am Main
20.5,28711,13832,14879,1401,Schwelm
31.27,28579,14061,14518,914,Reinbek
100.64,28466,14076,14390,283,Kevelaer
71.7,28453,13777,14676,397,Verden (Aller)
83.16,28399,14233,14166,341,Geilenkirchen
18.48,28377,13963,14414,1536,Königsbrunn
87.74,28345,13706,14639,323,Zeitz
38.27,28298,13614,14684,739,Baunatal
218.23,28269,13895,14374,130,Grimma
104.99,28264,14262,14002,269,Arnstadt
21.55,28210,14085,14125,1309,Griesheim
37.26,28202,13527,14675,757,Leichlingen (Rheinland)
43.5,28110,13583,14527,646,Neukirchen-Vluyn
29.92,28052,13687,14365,938,Olching
27.84,28005,13563,14442,1006,Baesweiler
91.11,27949,14053,13896,307,Lohne (Oldenburg)
21.59,27880,13740,14140,1291,Teltow
193.27,27783,13918,13865,144,Sundern (Sauerland)
67.94,27780,13383,14397,409,Strausberg
63.38,27647,13317,14330,436,Bad Neuenahr-Ahrweiler
52.12,27610,13758,13852,530,Heppenheim (Bergstraße)
101.35,27608,13454,14154,272,Wangen im Allgäu
106.6,27528,13904,13624,258,Butzbach
67.52,27520,13592,13928,408,Schloß Holte-Stukenbrock
178.33,27504,13895,13609,154,Ehingen (Donau)
68.88,27489,13409,14080,399,Overath
31.55,27450,13567,13883,870,Wetter (Ruhr)
164.53,27450,13691,13759,167,Hamminkeln
84.34,27305,13210,14095,324,Wegberg
20.64,27286,13458,13828,1322,Leimen
31.71,27245,13399,13846,859,Weinstadt
69.72,27238,13693,13545,391,Rheinbach
92.63,27143,13431,13712,293,Pfaffenhofen a.d.Ilm
48.56,27131,13242,13889,559,Hohen Neuendorf
30.24,27120,13496,13624,897,Wiesloch
117.12,26970,13228,13742,230,Werder (Havel)
60.41,26767,13299,13468,443,Selm
65.24,26664,13262,13402,409,Achern
54.32,26664,13302,13362,491,Mühlacker
31.48,26623,13004,13619,846,Hennigsdorf
54.47,26614,13264,13350,489,Groß-Gerau
27.52,26590,12934,13656,966,Heiligenhaus
22.82,26589,13270,13319,1165,Remseck am Neckar
24.94,26523,13195,13328,1063,Neckarsulm
156.83,26416,12722,13694,168,Aschersleben
59.86,26413,12944,13469,441,Lauf a.d.Pegnitz
87.77,26410,13210,13200,301,Nordenham
37.68,26339,13024,13315,699,Bingen am Rhein
34.4,26291,13396,12895,764,Weiterstadt
28.79,26257,12766,13491,912,Zirndorf
65.04,26161,12819,13342,402,Lübbecke
33.06,26155,12633,13522,791,Lindau (Bodensee)
100.59,26126,13156,12970,260,Harsewinkel
92.77,26052,12654,13398,281,Kulmbach
48.14,26025,12499,13526,541,Bad Honnef
30.13,25937,12728,13209,861,Friedrichsdorf
24.3,25904,12622,13282,1066,Schleswig
24.6,25863,12857,13006,1051,Geretsried
79.76,25709,12326,13383,322,Idstein
119.76,25695,13004,12691,215,Horb am Neckar
71.37,25691,12954,12737,360,Verl
66.74,25633,12510,13123,384,Helmstedt
109.02,25626,12544,13082,235,Rinteln
229.16,25624,12749,12875,112,Brilon
67.79,25591,12682,12909,378,Öhringen
71.76,25548,12642,12906,356,Rottweil
13.62,25531,12570,12961,1875,Obertshausen
12.16,25521,12386,13135,2099,Weingarten
113.54,25503,12487,13016,225,St. Wendel
96.33,25405,12374,13031,264,Roth
127.38,25372,12892,12480,199,Ellwangen (Jagst)
53.26,25356,12357,12999,476,Wiehl
85.92,25341,12489,12852,295,Delitzsch
30.38,25318,12564,12754,833,Ditzingen
45.68,25311,12534,12777,554,Stutensee
140.54,25306,12572,12734,180,Lüdinghausen
208.46,25300,12257,13043,121,Sangerhausen
42.54,25299,12522,12777,595,Pfungstadt
84.21,25294,12336,12958,300,Espelkamp
109.8,25283,12536,12747,230,Salzkotten
135.59,25275,12650,12625,186,Lennestadt
211.94,25226,12625,12601,119,Petershagen
106.33,25210,12342,12868,237,Norden
77.96,25114,12405,12709,322,Waldshut-Tiengen
52.59,25104,12275,12829,477,Bad Oldesloe
34.84,25031,12125,12906,718,Meckenheim
77.85,24974,12102,12872,321,Köthen (Anhalt)
303.1,24970,12604,12366,82,Schmallenberg
85.88,24961,12375,12586,291,Olpe
47.94,24956,12094,12862,521,Sprockhövel
128.11,24956,12269,12687,195,Syke
113.1,24918,12106,12812,220,Rathenow
105.64,24867,12273,12594,235,Meiningen
96.75,24788,12353,12435,256,Plettenberg
135.17,24767,12047,12720,183,Rudolstadt
129.96,24752,12156,12596,190,Bad Mergentheim
208.79,24719,12493,12226,118,Haren (Ems)
66.75,24710,12238,12472,370,Zittau
47.62,24674,12302,12372,518,Herzogenaurach
80.42,24645,12171,12474,306,Bedburg
21.56,24604,12241,12363,1141,Waldkraiburg
37.82,24505,12125,12380,648,Ronnenberg
31.47,24488,11697,12791,778,Markkleeberg
73.73,24464,12335,12129,332,Riedstadt
158.05,24464,12229,12235,155,Warstein
97.92,24452,12254,12198,250,Attendorn
59.88,24448,12360,12088,408,Calw
63.47,24447,11974,12473,385,Eisenhüttenstadt
26.09,24354,12236,12118,933,Übach-Palenberg
87.54,24337,11892,12445,278,Freudenstadt
113.75,24335,11834,12501,214,Varel
103.58,24167,12148,12019,233,Sehnde
71.77,24141,11899,12242,336,Jüchen
124.11,24089,11782,12307,194,Korbach
179.55,23984,11691,12293,134,Westerstede
147.18,23963,11635,12328,163,Staßfurt
61.85,23940,11255,12685,387,Starnberg
50.21,23923,11762,12161,476,Limbach-Oberfrohna
45.15,23841,11605,12236,528,Gelnhausen
25.8,23814,11391,12423,923,Husum
91.75,23728,11700,12028,259,Döbeln
62.16,23647,11875,11772,380,Mosbach
174.97,23588,11868,11720,135,Leutkirch im Allgäu
83.76,23533,11705,11828,281,Dillenburg
34.01,23492,11664,11828,691,Gersthofen
23.11,23478,11420,12058,1016,Kaltenkirchen
84.69,23435,11398,12037,277,Sonneberg
137.39,23430,11635,11795,171,Netphen
121.17,23418,11516,11902,193,Hann. Münden
306.15,23394,11626,11768,76,Salzwedel
55.5,23378,11323,12055,421,Weilheim i.OB
46.99,23377,11594,11783,497,Kitzingen
168.84,23336,11453,11883,138,Warburg
63.1,23321,11588,11733,370,Nagold
138.59,23319,11630,11689,168,Wertheim
127.56,23282,11184,12098,183,Senftenberg/Zły Komorow
120.79,23277,11042,12235,193,Quedlinburg
135.83,23265,11880,11385,171,Vreden
43.94,23253,11583,11670,529,Karben
25.22,23251,11159,12092,922,Neusäß
69.92,23245,10882,12363,332,Bad Kissingen
58.64,23240,10883,12357,396,Überlingen
247.5,23234,11630,11604,94,Friesoythe
12.5,23174,11135,12039,1854,Bad Soden am Taunus
25.21,23143,11290,11853,918,Senden
152.02,23133,11320,11813,152,Bad Salzungen
90.79,23067,11481,11586,254,Lengerich
61.79,23044,11570,11474,373,Laupheim
60.27,22924,11124,11800,380,Stadthagen
46.26,22896,11244,11652,495,Apolda
99.06,22789,11185,11604,230,Rotenburg (Wümme)
165.55,22738,11504,11234,137,Burg
22.39,22665,10768,11897,1012,Herdecke
144.74,22609,11128,11481,156,Eisleben
122.88,22607,11336,11271,184,Büdingen
73.56,22586,11223,11363,307,Bad Rappenau
12.13,22551,11295,11256,1859,Eschborn
34.55,22530,11150,11380,652,Metzingen
31.97,22467,10915,11552,703,Heide
43.16,22339,10864,11475,518,Quickborn
104.69,22312,11121,11191,213,Donaueschingen
48.47,22266,10808,11458,459,Waldkirch
88.58,22252,11130,11122,251,Eppingen
85.57,22242,11155,11087,260,Versmold
92.83,22222,10804,11418,239,Aichach
69.7,22198,10952,11246,318,Halle (Westf.)
53.86,22159,10785,11374,411,Radevormwald
203.77,22040,10791,11249,108,Soltau
46.55,22035,10514,11521,473,Sonthofen
66.17,21993,10844,11149,332,Elsdorf
35.69,21971,10828,11143,616,Bad Krozingen
636.27,21926,10918,11008,34,Gardelegen
16.41,21894,10863,11031,1334,Eislingen/Fils
55.4,21865,10880,10985,395,Günzburg
29.42,21860,10868,10992,743,Mühldorf a.Inn
51.62,21807,10651,11156,422,Glauchau
72.43,21776,10646,11130,301,Xanten
42.84,21766,10888,10878,508,Waghäusel
30.85,21752,10457,11295,705,Seligenstadt
22.99,21751,10652,11099,946,Flörsheim am Main
97.89,21749,10825,10924,222,Geseke
78.24,21733,10820,10913,278,Stadtallendorf
180.38,21643,11253,10390,120,Zossen
34.84,21631,10694,10937,621,Hockenheim
21.58,21620,10256,11364,1002,Eckernförde
21.5,21609,10539,11070,1005,Schwetzingen
48.57,21551,10444,11107,444,Traunstein
170.99,21524,11108,10416,126,Büren
65.52,21503,9998,11505,328,Bad Harzburg
202.32,21497,10388,11109,106,Spremberg/Grodk
470.91,21483,10571,10912,46,Zerbst/Anhalt
109.86,21452,10720,10732,195,Rees
89.7,21424,10587,10837,239,Wildeshausen
12.24,21410,10425,10985,1749,Puchheim
102.54,21382,10535,10847,209,Osterode am Harz
101.01,21375,10578,10797,212,Zülpich
21.68,21295,10718,10577,982,Germersheim
80.7,21231,10642,10589,263,Schramberg
159.46,21217,9928,11289,133,Waren (Müritz)
201.21,21183,10452,10731,105,Sondershausen
63.76,21142,10452,10690,332,Herborn
118.3,21059,10494,10565,178,Wipperfürth
68.09,21053,10483,10570,309,Nördlingen
107.54,21049,10599,10450,196,Hörstel
45.06,21021,10433,10588,467,Traunreut
86.84,21018,10380,10638,242,Groß-Umstadt
32.27,21009,10145,10864,651,Wülfrath
46.61,21000,10258,10742,451,Luckenwalde
50.03,20979,10203,10776,419,Mössingen
68.79,20932,10196,10736,304,Schortens
44.0,20927,10978,9949,476,Dingolfing
29.88,20894,10202,10692,699,Bruchköbel
210.16,20835,10236,10599,99,Wittmund
65.62,20793,10344,10449,317,Werdau
79.25,20791,10455,10336,262,Stadtlohn
108.55,20786,10203,10583,191,Bad Waldsee
41.24,20724,10239,10485,503,Enger
32.31,20695,10065,10630,641,Rheinstetten
28.06,20682,10291,10391,737,Schifferstadt
115.69,20653,10235,10418,179,Meinerzhagen
46.73,20652,10186,10466,442,Nidderau
25.88,20561,9839,10722,794,Coswig
152.85,20481,9746,10735,134,Burgwedel
56.23,20450,10058,10392,364,Fröndenberg/Ruhr
122.16,20403,10083,10320,167,Lichtenfels
20.71,20394,10195,10199,985,Korntal-Münchingen
105.63,20392,10398,9994,193,Ochtrup
139.89,20385,9771,10614,146,Neustrelitz
44.07,20358,10177,10181,462,Giengen an der Brenz
95.64,20320,9972,10348,212,Duderstadt
90.9,20301,9879,10422,223,Telgte
34.47,20273,9737,10536,588,Reichenbach im Vogtland
71.25,20262,10091,10171,284,Tettnang
67.93,20238,9816,10422,298,Schopfheim
69.1,20237,10053,10184,293,Oberkirch
84.86,20220,9803,10417,238,Greiz
88.23,20217,10052,10165,229,Holzminden
108.21,20202,9947,10255,187,Blieskastel
18.39,20169,9364,10805,1097,Bad Schwartau
77.04,20108,10018,10090,261,Donauwörth
63.32,20081,9771,10310,317,Waldbröl
75.59,20070,9917,10153,266,Dillingen a.d.Donau
115.79,20053,9955,10098,173,Leinefelde-Worbis
43.85,20027,10113,9914,457,Moosburg a.d.Isar
62.45,20013,9715,10298,320,Borna
105.38,19984,10298,9686,190,Schmalkalden
24.71,19964,10239,9725,808,Bad Friedrichshall
22.05,19941,9753,10188,904,Dillingen/ Saar
43.0,19896,9813,10083,463,Sarstedt
189.88,19885,9948,9937,105,Oschersleben (Bode)
58.19,19882,9923,9959,342,Mayen
78.9,19837,9956,9881,251,Rhede
9.99,19817,9639,10178,1984,Schenefeld
125.56,19812,9893,9919,158,Ennigerloh
17.01,19774,9714,10060,1162,Gerlingen
57.91,19756,9574,10182,341,Müllheim im Markgräflerland
68.9,19754,9539,10215,287,Bückeburg
41.4,19745,9523,10222,477,Bad Aibling
49.64,19718,9962,9756,397,Wittlich
182.22,19704,10152,9552,108,Marsberg
36.43,19698,9426,10272,541,Aue-Bad Schlema
102.82,19683,9669,10014,191,Torgau
106.73,19596,9770,9826,184,Haiger
61.99,19596,9384,10212,316,Bad Pyrmont
25.05,19566,9293,10273,781,Mölln
268.15,19563,9768,9795,73,Nauen
53.12,19548,9709,9839,368,Sulzbach-Rosenberg
42.43,19541,9629,9912,461,Wassenberg
35.22,19530,9737,9793,555,Alzey
9.13,19499,9465,10034,2136,Wolfratshausen
115.3,19496,9679,9817,169,Bad Driburg
19.81,19494,9601,9893,984,Burghausen
57.92,19480,9645,9835,336,Sachsenheim
66.41,19475,9618,9857,293,Hechingen
28.15,19470,9415,10055,692,Annaberg-Buchholz
63.26,19435,9294,10141,307,Eschwege
19.03,19426,9649,9777,1021,Heusenstamm
19.83,19414,9410,10004,979,Kolbermoor
30.8,19360,9411,9949,629,Bad Tölz
43.17,19340,9560,9780,448,Weil der Stadt
81.47,19234,9918,9316,236,Schkeuditz
30.14,19221,9377,9844,638,Pfullingen
157.13,19188,9502,9686,122,Haldensleben
102.33,19185,9313,9872,187,Seesen
234.92,19169,9273,9896,82,Schneverdingen
64.21,19108,9886,9222,298,Lebach
41.92,19087,9229,9858,455,Bad Reichenhall
87.56,19052,9381,9671,218,Sömmerda
149.21,19034,9166,9868,128,Blankenburg (Harz)
95.15,19033,9651,9382,200,Marktoberdorf
150.42,19023,9534,9489,126,Bremervörde
142.97,19022,9191,9831,133,Prenzlau
27.33,19005,9310,9695,695,Burscheid
97.58,18931,9331,9600,194,Weißenburg i.Bay.
18.87,18891,9365,9526,1001,Bad Segeberg
31.73,18885,9147,9738,595,Hemmingen
275.52,18833,9523,9310,68,Bad Berleburg
29.83,18824,9207,9617,631,Radeberg
102.55,18821,8885,9936,184,Bad Dürkheim
19.47,18810,9255,9555,966,Hochheim am Main
59.3,18787,9202,9585,317,Alzenau
11.43,18776,9232,9544,1643,Uetersen
72.88,18679,9211,9468,256,Alfeld (Leine)
84.79,18661,9443,9218,220,Schwalmstadt
11.21,18656,9152,9504,1664,Glinde
31.15,18655,9210,9445,599,Renningen
13.97,18622,8903,9719,1333,Vellmar
37.89,18621,9044,9577,491,Bergneustadt
36.39,18578,9214,9364,511,Illertissen
18.58,18569,8820,9749,999,Kronberg im Taunus
120.32,18556,9071,9485,154,Hessisch Oldendorf
44.57,18539,9125,9414,416,Konz
37.62,18536,8982,9554,493,Lahnstein
61.14,18479,8993,9486,302,Crimmitschau
131.62,18405,9085,9320,140,Wörth am Rhein
76.93,18403,9265,9138,239,Vlotho
124.81,18270,8826,9444,146,Parchim
23.95,18243,8785,9458,762,Püttlingen
138.93,18203,8923,9280,131,Buchen (Odenwald)
75.26,18199,9099,9100,242,Schrobenhausen
38.0,18199,8930,9269,479,Pohlheim
124.86,18138,9131,9007,145,Frankenberg (Eder)
92.84,18127,9206,8921,195,Sigmaringen
130.36,18077,8868,9209,139,Großenhain
86.29,18061,8995,9066,209,Vilshofen an der Donau
14.81,18036,8780,9256,1218,Freilassing
50.26,18022,8920,9102,359,Bobingen
12.09,17807,8591,9216,1473,Oberasbach
118.33,17768,8953,8815,150,Nidda
33.38,17762,8788,8974,532,Werdohl
24.2,17744,8953,8791,733,Trossingen
54.6,17738,8846,8892,325,Freudenberg
97.34,17724,8770,8954,182,Bad Saulgau
110.69,17721,8600,9121,160,Forst (Lausitz)/Baršć (Łužyca)
104.39,17686,8807,8879,169,Damme
57.79,17683,8556,9127,306,Bad Wörishofen
31.09,17663,8675,8988,568,Bexbach
25.35,17637,8443,9194,696,Bad Säckingen
104.7,17608,8627,8981,168,Diepholz
80.69,17593,8840,8753,218,Cham
66.85,17579,8744,8835,263,Babenhausen
28.17,17577,9060,8517,624,Garching b.München
150.83,17568,8486,9082,116,Bad Münstereifel
55.52,17562,8464,9098,316,Auerbach/Vogtl.
107.97,17511,8606,8905,162,Bad Münder am Deister
120.1,17473,8597,8876,145,Bad Wildungen
80.84,17467,8809,8658,216,Gescher
47.55,17465,8775,8690,367,Bitburg
69.73,17402,8571,8831,250,Stockach
41.1,17399,8492,8907,423,Sinzig
33.21,17387,8606,8781,524,Remagen
11.65,17370,8537,8833,1491,Schwarzenbek
15.41,17365,8956,8409,1127,Kelsterbach
129.37,17338,8444,8894,134,Bad Langensalza
90.15,17329,8459,8870,192,Horn-Bad Meinberg
41.38,17296,8169,9127,418,Eutin
32.69,17287,8417,8870,529,Oerlinghausen
70.87,17260,8588,8672,244,Heilbad Heiligenstadt
49.52,17254,8339,8915,348,Marktredwitz
82.72,17237,8340,8897,208,Gunzenhausen
24.12,17208,8521,8687,713,Bendorf
13.94,17143,8504,8639,1230,Ginsheim-Gustavsburg
119.75,17130,8722,8408,143,Hünfeld
100.23,17094,8548,8546,171,Kelheim
46.77,17040,8257,8783,364,Eltville am Rhein
50.63,16982,8285,8697,335,Wittenberge
34.46,16980,8417,8563,493,Bürstadt
66.98,16924,8330,8594,253,Kronach
25.73,16909,8284,8625,657,Penzberg
51.01,16884,8191,8693,331,Bad Lippspringe
98.3,16861,8366,8495,172,Kamenz / Kamjenc
25.05,16831,8036,8795,672,Königstein im Taunus
45.75,16795,8537,8258,367,Brackenheim
168.85,16794,8372,8422,99,Bassum
27.7,16729,8253,8476,604,Reinheim
137.94,16721,8216,8505,121,Thale
69.0,16715,8056,8659,242,Wurzen
11.07,16667,8165,8502,1506,Heidenau
55.61,16606,8425,8181,299,Blaustein
90.95,16578,8177,8401,182,Kirchhain
12.6,16564,8409,8155,1315,Raunheim
74.0,16544,8262,8282,224,Straelen
68.86,16509,8077,8432,240,Pocking
89.41,16484,8110,8374,184,Erwitte
75.18,16436,8339,8097,219,Künzelsau
133.49,16420,8172,8248,123,Marienberg
16.07,16368,8066,8302,1019,Sulzbach/ Saar
99.99,16321,8112,8209,163,Bad Bentheim
15.82,16320,7825,8495,1032,Bargteheide
71.91,16320,8006,8314,227,Kierspe
44.42,16315,8081,8234,367,Altena
173.92,16310,8152,8158,94,Brakel
77.23,16284,8012,8272,211,Halver
13.14,16227,7941,8286,1235,Freiberg am Neckar
56.42,16226,8170,8056,288,Mindelheim
43.99,16210,7712,8498,368,Guben
129.71,16205,8035,8170,125,Alsfeld
46.85,16201,7798,8403,346,Eilenburg
14.4,16186,7675,8511,1124,Preetz
18.58,16162,8139,8023,870,Erlensee
12.15,16159,7997,8162,1330,Wendlingen am Neckar
58.46,16145,7911,8234,276,Markranstädt
113.3,16126,8020,8106,142,Schlüchtern
43.5,16072,7613,8459,369,Füssen
18.06,16010,7870,8140,886,Marbach am Neckar
54.59,16007,7900,8107,293,Breisach am Rhein
19.91,15995,7891,8104,803,Walldorf
126.47,15984,7925,8059,126,Bad Arolsen
86.98,15975,7893,8082,184,Michelstadt
81.23,15916,7934,7982,196,Weener
135.14,15890,7719,8171,118,Zeulenroda-Triebes
106.6,15865,7816,8049,149,Drensteinfurt
77.52,15864,7609,8255,205,Finsterwalde
131.13,15860,7853,8007,121,Königslutter am Elm
111.22,15860,7919,7941,143,Wadern
137.48,15859,8007,7852,115,Rahden
75.03,15792,7981,7811,210,Langenau
139.51,15774,7711,8063,113,Lübbenau/Spreewald / Lubnjow/Błota
26.26,15768,7800,7968,600,Ebersbach an der Fils
33.22,15759,7617,8142,474,Taucha
19.73,15749,7421,8328,798,Neustadt in Holstein
48.59,15746,7838,7908,324,Altdorf b.Nürnberg
46.31,15740,7560,8180,340,Schwarzenberg/Erzgeb.
122.83,15729,7433,8296,128,Ribnitz-Damgarten
23.08,15723,7682,8041,681,Dieburg
36.9,15720,7682,8038,426,Bad Neustadt a.d.Saale
86.37,15626,7612,8014,181,Hofgeismar
11.49,15614,7663,7951,1359,Stadtbergen
379.59,15604,7494,8110,41,Templin
74.88,15593,7615,7978,208,Boppard
6.47,15566,7554,8012,2406,Schwalbach am Taunus
5.7,15543,7676,7867,2727,Eppelheim
61.54,15517,7853,7664,252,Mainburg
24.14,15451,7527,7924,640,Bad Bramstedt
43.69,15436,8637,6799,353,Clausthal-Zellerfeld
99.1,15417,7757,7660,156,Blomberg
194.52,15413,7891,7522,79,Munster
90.42,15353,7671,7682,170,Lohr a.Main
43.27,15329,7333,7996,354,Gehrden
41.88,15313,7563,7750,366,Ober-Ramstadt
31.61,15309,7498,7811,484,Schriesheim
99.56,15197,7560,7637,153,Dorfen
85.39,15190,7647,7543,178,Isny im Allgäu
38.3,15102,7393,7709,394,Brake (Unterweser)
88.81,15101,7438,7663,170,Fritzlar
28.17,15099,7570,7529,536,Markgröningen
126.78,15097,7392,7705,119,Witzenhausen
55.81,15095,7384,7711,270,Usingen
61.89,15089,7465,7624,244,Neustadt b.Coburg
125.99,15088,7521,7567,120,Landsberg
182.24,15083,7682,7401,83,Bad Wurzach
98.15,15062,7443,7619,153,Karlstadt
63.43,14992,7152,7840,236,Weißwasser/O.L.
108.76,14960,7434,7526,138,Langelsheim
93.53,14949,7651,7298,160,Neustadt a.d.Donau
55.5,14926,7313,7613,269,Schwabmünchen
42.24,14913,7033,7880,353,Jever
116.93,14860,7347,7513,127,Münsingen
19.51,14851,7083,7768,761,Stein
50.52,14770,7420,7350,292,Hückeswagen
24.79,14753,7282,7471,595,Uhingen
86.07,14727,7157,7570,171,Selb
81.12,14714,7296,7418,181,Hilchenbach
100.11,14712,7456,7256,147,Homberg (Efze)
60.26,14685,7551,7134,244,Abensberg
55.92,14684,7335,7349,263,Oberndorf am Neckar
67.12,14678,7128,7550,219,Pattensen
33.77,14677,7138,7539,435,Montabaur
80.59,14635,7261,7374,182,Kraichtal
26.23,14630,7162,7468,558,Langenselbold
81.44,14622,7045,7577,180,Immenstadt i.Allgäu
9.75,14614,7275,7339,1499,Neutraubling
81.6,14613,7211,7402,179,Wilsdruff
20.61,14606,7129,7477,709,Tornesch
94.44,14596,7264,7332,155,Lauda-Königshofen
10.64,14590,7267,7323,1371,Plochingen
78.08,14566,7396,7170,187,Sassenberg
30.29,14552,6889,7663,480,Ratzeburg
93.26,14527,7170,7357,156,Burglengenfeld
45.56,14522,7294,7228,319,Ottweiler
81.15,14489,7066,7423,179,Eberbach
118.0,14481,7167,7314,123,Olsberg
44.35,14439,7157,7282,326,Eggenfelden
82.03,14438,7181,7257,176,Gernsbach
40.91,14406,7161,7245,352,Markdorf
84.4,14402,7290,7112,171,Landau a.d.Isar
82.16,14398,6946,7452,175,Sandersdorf-Brehna
40.35,14389,7075,7314,357,Spenge
78.9,14389,6970,7419,182,Löbau
74.13,14376,7282,7094,194,Zeven
36.12,14359,7033,7326,398,Neu-Anspach
29.58,14348,7066,7282,485,Grafing b.München
77.61,14310,6988,7322,184,Lich
71.15,14248,7080,7168,200,Murrhardt
54.6,14229,6928,7301,261,Bad Camberg
88.2,14199,7090,7109,161,Kalkar
41.26,14198,7081,7117,344,Mittweida
103.99,14174,6982,7192,136,Dippoldiswalde
88.12,14174,7077,7097,161,Leuna
18.09,14169,6972,7197,783,Grünstadt
113.59,14166,7012,7154,125,Uslar
23.69,14134,6955,7179,597,Vöhringen
36.18,14119,7021,7098,390,Buchloe
63.09,14107,7039,7068,224,Melsungen
61.52,14099,6886,7213,229,Erbach
55.44,14089,6895,7194,254,Oschatz
25.24,14088,6853,7235,558,Lorsch
53.72,14088,7099,6989,262,Weißenhorn
63.29,14080,7082,6998,222,Erbach
70.87,14063,6993,7070,198,Höchstadt a.d.Aisch
43.57,14043,6962,7081,322,Aßlar
17.81,14032,6737,7295,788,Schwentinental
23.35,14028,7019,7009,601,Schneeberg
79.97,14020,6900,7120,175,Rotenburg a. d. Fulda
420.21,13994,6922,7072,33,Wittstock/Dosse
48.8,13985,6898,7087,287,Ettenheim
52.66,13982,6956,7026,266,Haßfurt
120.85,13967,6667,7300,116,Lübben (Spreewald) / Lubin (Błota)
353.93,13966,6963,7003,39,Jessen (Elster)
58.59,13960,6915,7045,238,Bad Soden-Salmünster
89.72,13953,7079,6874,156,Hilpoltstein
89.3,13951,6805,7146,156,Lauchhammer
17.96,13947,6871,7076,777,Quakenbrück
44.64,13940,6838,7102,312,Krumbach (Schwaben)
89.22,13940,6818,7122,156,Grünberg
18.58,13937,6725,7212,750,Hohenstein-Ernstthal
34.02,13921,6945,6976,409,Solms
50.54,13910,7099,6811,275,Philippsburg
93.71,13908,6843,7065,148,Bebra
101.98,13883,6772,7111,136,Lauterbach (Hessen)
47.79,13867,6675,7192,290,Eichstätt
65.62,13862,6836,7026,211,Frankenberg/Sa.
13.39,13841,6805,7036,1034,Holzgerlingen
5.8,13836,6864,6972,2386,Asperg
143.52,13823,6863,6960,96,Löningen
19.81,13797,6725,7072,696,Meerane
18.5,13795,6924,6871,746,Spaichingen
181.31,13794,6917,6877,76,Beelitz
62.08,13793,6659,7134,222,Bad Dürrheim
324.24,13775,6618,7157,42,Angermünde
96.95,13760,6787,6973,142,Sendenhorst
99.98,13741,6861,6880,137,Pegnitz
90.31,13717,6855,6862,152,Biedenkopf
52.35,13694,6822,6872,262,Pfarrkirchen
188.44,13669,6816,6853,73,Wanzleben-Börde
159.43,13663,6737,6926,86,Haselünne
90.5,13654,6728,6926,151,Pfullendorf
51.49,13650,6544,7106,265,Bergen auf Rügen
232.69,13646,6704,6942,59,Genthin
24.19,13645,6651,6994,564,Eppstein
22.77,13631,6776,6855,599,Linden
26.16,13629,6676,6953,521,Neckargemünd
69.29,13621,6766,6855,197,Tauberbischofsheim
82.94,13610,6579,7031,164,Wiesmoor
94.53,13607,6675,6932,144,Schmölln
61.21,13523,6570,6953,221,Neustadt a.d.Aisch
67.18,13523,6618,6905,201,Bad Salzdetfurth
164.39,13520,6674,6846,82,Bergen
135.95,13504,6809,6695,99,Bad Laasphe
37.03,13498,6641,6857,365,Hettstedt
249.96,13479,6771,6708,54,Oebisfelde-Weferlingen
72.8,13468,6702,6766,185,Dinklage
22.22,13468,6769,6699,606,Weinsberg
110.83,13430,6636,6794,121,Sulingen
112.29,13411,6665,6746,119,Wolfhagen
57.51,13395,6731,6664,233,Weilburg
19.45,13387,6738,6649,688,Schüttorf
70.75,13381,6758,6623,189,Velen
53.28,13299,6799,6500,250,Östringen
52.43,13298,6406,6892,254,Olfen
98.09,13277,6562,6715,135,Beverungen
35.9,13270,6651,6619,370,Plattling
223.06,13267,6601,6666,59,Zehdenick
121.67,13233,6654,6579,109,Schleiden
119.61,13224,6852,6372,111,Roding
185.5,13218,6407,6811,71,Fehmarn
59.85,13203,6544,6659,221,St. Georgen im Schwarzwald
45.33,13199,6465,6734,291,Rosbach v. d. Höhe
103.38,13181,6739,6442,128,Treuchtlingen
58.63,13179,6530,6649,225,Herbrechtingen
23.07,13172,6283,6889,571,Altötting
35.64,13113,6430,6683,368,Wehr
18.8,13112,6603,6509,697,Wasserburg a.Inn
32.85,13105,6217,6888,399,Bad Doberan
40.99,13093,6699,6394,319,Hadamar
50.79,13061,6514,6547,257,Wächtersbach
65.43,13056,6488,6568,200,Linnich
86.78,13033,6430,6603,150,Hungen
193.41,13004,6546,6458,67,Südliches Anhalt
114.38,12952,6545,6407,113,Twistringen
49.97,12947,6393,6554,259,Rödental
16.83,12923,6482,6441,768,Besigheim
527.78,12885,6532,6353,24,Möckern
137.21,12875,6476,6399,94,Feuchtwangen
105.72,12798,6501,6297,121,Hessisch Lichtenau
147.95,12792,6432,6360,86,Winterberg
71.88,12783,6278,6505,178,Herzberg am Harz
22.9,12772,6227,6545,558,Hersbruck
21.34,12769,6298,6471,598,Schongau
78.24,12766,6221,6545,163,Bad Windsheim
87.62,12760,6401,6359,146,Sulz am Neckar
55.42,12755,6340,6415,230,Bad Urach
23.42,12733,6274,6459,544,Velten
8.78,12726,6390,6336,1449,Tamm
19.0,12704,6144,6560,669,Ladenburg
176.48,12661,6116,6545,72,Jüterbog
79.11,12657,6412,6245,160,Blaubeuren
65.21,12651,6396,6255,194,Brunsbüttel
75.69,12643,6208,6435,167,Steinheim
68.84,12621,6312,6309,183,Vilsbiburg
72.28,12594,6309,6285,174,Gladenbach
14.29,12565,6085,6480,879,Röthenbach a.d.Pegnitz
82.46,12565,6311,6254,152,Borken (Hessen)
161.3,12546,6283,6263,78,Bad Wünnenberg
40.84,12527,6161,6366,307,Ebersberg
44.1,12520,6255,6265,284,Neuenburg am Rhein
60.62,12512,6201,6311,206,Waltershausen
68.76,12456,6137,6319,181,Preußisch Oldendorf
69.83,12447,6332,6115,178,Laichingen
52.99,12445,6126,6319,235,Zella-Mehlis
10.89,12443,6178,6265,1143,Wernau (Neckar)
78.64,12420,5974,6446,158,Ludwigslust
89.64,12395,6113,6282,138,Titisee-Neustadt
56.68,12363,5822,6541,218,Anklam
62.59,12361,6131,6230,197,Gaildorf
67.54,12344,6135,6209,183,Hagenow
131.11,12296,6018,6278,94,Bad Freienwalde (Oder)
34.69,12278,6177,6101,354,Maxhütte-Haidhof
75.16,12272,6014,6258,163,Dinkelsbühl
123.3,12263,6099,6164,99,Burladingen
111.16,12237,6116,6121,110,Osterhofen
145.29,12186,6006,6180,84,Frohburg
64.02,12119,6014,6105,189,Bad Fallingbostel
32.44,12109,5993,6116,373,Miesbach
61.73,12092,5964,6128,196,Wolgast
23.18,12082,5959,6123,521,Steinheim an der Murr
138.69,12026,5891,6135,87,Perleberg
16.53,12008,5695,6313,726,Erkner
9.56,11999,5974,6025,1255,Lauenburg/ Elbe
33.57,11956,5885,6071,356,Oberderdingen
83.12,11929,5753,6176,144,Neustadt in Sachsen
94.6,11895,5867,6028,126,Monschau
12.85,11884,5799,6085,925,Hemsbach
22.63,11863,5901,5962,524,Lauffen am Neckar
24.43,11858,5699,6159,485,Pößneck
54.1,11835,5866,5969,219,Neuenrade
36.26,11801,5774,6027,325,Bad Dürrenberg
91.36,11790,5892,5898,129,Billerbeck
54.38,11782,5669,6113,217,Wolmirstedt
40.34,11776,5779,5997,292,Geisenheim
82.79,11775,5816,5959,142,Hauzenberg
23.47,11772,5833,5939,502,Leingarten
59.51,11769,5733,6036,198,Oestrich-Winkel
67.11,11766,5956,5810,175,Drolshagen
105.91,11760,5978,5782,111,Walldürn
11.84,11741,5802,5939,992,Lindenberg i.Allgäu
167.32,11736,5770,5966,70,Pritzwalk
88.3,11729,6129,5600,133,Geisenfeld
49.49,11726,5910,5816,237,Schwaigern
35.7,11724,5872,5852,328,Marktheidenfeld
64.24,11702,5656,6046,182,Zwönitz
76.96,11696,5771,5925,152,Bopfingen
72.89,11682,5799,5883,160,Hildburghausen
23.22,11629,5618,6011,501,Bad Nenndorf
40.27,11602,5723,5879,288,Bad Schwalbach
296.82,11468,5755,5713,39,Coswig (Anhalt)
51.55,11463,5613,5850,222,Trostberg
44.39,11445,5770,5675,258,Lauingen (Donau)
63.57,11434,5708,5726,180,Ochsenfurt
70.56,11431,5701,5730,162,Engen
20.45,11421,5471,5950,558,Ebersbach-Neugersdorf
12.41,11388,5923,5465,918,Diez
225.83,11388,5715,5673,50,Wittingen
41.67,11385,5476,5909,273,Rothenburg ob der Tauber
159.92,11380,5510,5870,71,Gräfenhainichen
37.99,11378,5553,5825,299,Welzheim
73.5,11365,5730,5635,155,Rheinau
16.42,11321,5583,5738,689,Mülheim-Kärlich
64.96,11271,5814,5457,174,Riedlingen
42.8,11260,5672,5588,263,Isselburg
35.48,11242,5668,5574,317,Herbolzheim
80.01,11221,5560,5661,140,Waldkirchen
236.09,11216,5456,5760,48,Bad Belzig
24.67,11196,5441,5755,454,Eisenberg
16.22,11194,5531,5663,690,Rutesheim
35.42,11193,5498,5695,316,Werther (Westf.)
47.28,11167,5374,5793,236,Braunfels
35.47,11167,5434,5733,315,Schöningen
74.81,11108,5535,5573,148,Balve
76.8,11086,5679,5407,144,Meßstetten
36.93,11071,5489,5582,300,Kenzingen
158.15,11049,5699,5350,70,Rüthen
76.44,11044,5518,5526,144,Haigerloch
38.99,11033,5272,5761,283,Stollberg/Erzgeb.
34.28,11032,5550,5482,322,Lorch
39.82,11031,5535,5496,277,Donzdorf
65.14,11009,5489,5520,169,Regen
40.11,11006,5482,5524,274,Gernsheim
9.11,10994,5429,5565,1207,Wildau
22.75,10987,5437,5550,483,Glückstadt
61.9,10984,5308,5676,177,Gengenbach
53.19,10983,5598,5385,206,Altensteig
192.57,10940,5629,5311,57,Lichtenau
46.33,10924,5291,5633,236,Langenzenn
26.28,10883,5282,5601,414,Oelsnitz/Erzgeb.
88.39,10882,5380,5502,123,Gronau (Leine)
47.42,10881,5388,5493,229,Boizenburg/ Elbe
4.4,10869,5249,5620,2470,Steinbach (Taunus)
15.47,10853,5200,5653,702,Lichtenstein/Sa.
128.88,10826,5354,5472,84,Hammelburg
107.47,10789,5406,5383,100,Dingelstädt
213.11,10768,5459,5309,51,Osterwieck
47.75,10759,5164,5595,225,Bad Orb
31.9,10730,5431,5299,336,Dissen am Teutoburger Wald
26.7,10708,5307,5401,401,Endingen am Kaiserstuhl
17.17,10683,5223,5460,622,Barmstedt
83.32,10658,5300,5358,128,Felsberg
99.51,10651,5184,5467,107,Bad Staffelstein
31.37,10650,5345,5305,339,Neuenhaus
46.21,10648,5085,5563,230,Bischofswerda
25.92,10628,5386,5242,410,Burgau
105.22,10601,5202,5399,101,Bad Wildbad
63.81,10588,5421,5167,166,Werlte
36.47,10574,5087,5487,290,Bad Iburg
47.33,10521,5166,5355,222,Simbach a.Inn
297.07,10516,5245,5271,35,Tangerhütte
21.39,10509,5183,5326,491,Lollar
6.48,10470,4993,5477,1616,Büdelsdorf
161.36,10464,5086,5378,65,Gommern
125.59,10449,5158,5291,83,Schleusingen
27.76,10426,5006,5420,376,Flöha
52.33,10422,5245,5177,199,Aulendorf
74.64,10413,5229,5184,140,Braunsbedra
25.88,10402,5079,5323,402,Burgstädt
9.56,10401,5145,5256,1088,Betzdorf
52.38,10398,5035,5363,199,Grevesmühlen
65.04,10397,5070,5327,160,Nideggen
26.51,10397,5207,5190,392,Weilheim an der Teck
11.22,10393,5045,5348,926,Nieder-Olm
104.86,10381,5158,5223,99,Steinau an der Straße
122.74,10377,5203,5174,85,Nossen
56.68,10372,5271,5101,183,Wildberg
12.79,10366,5130,5236,810,Süßen
41.17,10350,5213,5137,251,Neuenstadt am Kocher
16.31,10335,5173,5162,634,Erlenbach a.Main
49.74,10333,5149,5184,208,Bogen
98.72,10329,5194,5135,105,Blumberg
125.34,10307,5079,5228,82,Olbernhau
82.06,10293,4866,5427,125,Demmin
100.02,10282,5230,5052,103,Beilngries
41.56,10258,4948,5310,247,Bad Lauterberg im Harz
156.38,10253,4955,5298,66,Querfurt
90.45,10228,4895,5333,113,Tangermünde
68.78,10200,4958,5242,148,Münchberg
99.97,10188,5152,5036,102,Rehburg-Loccum
51.41,10180,5070,5110,198,Rüdesheim am Rhein
30.63,10159,4900,5259,332,Niebüll
108.17,10151,5095,5056,94,Bleicherode
165.61,10129,5069,5060,61,Oberzent
25.78,10105,4968,5137,392,Heubach
99.13,10084,5122,4962,102,Mittenwalde
53.66,10079,4866,5213,188,Meuselwitz
49.81,10077,5070,5007,202,Mengen
40.25,10059,4969,5090,250,Niddatal
46.49,10059,5005,5054,216,Gudensberg
133.56,10053,5108,4945,75,Schotten
56.86,10051,5321,4730,177,Neustadt (Hessen)
15.75,10050,4866,5184,638,Wahlstedt
91.06,10042,4961,5081,110,Bad Frankenhausen/Kyffhäuser
23.6,10031,5042,4989,425,Aichtal
75.06,10012,5008,5004,133,Gemünden a.Main
15.41,10002,4854,5148,649,Bad Ems
142.06,9987,5009,4978,70,Schlitz
39.69,9983,4834,5149,252,Oldenburg in Holstein
48.37,9983,4600,5383,206,Bad Bevensen
126.36,9964,5049,4915,79,Trebbin
8.99,9887,4799,5088,1100,Friedrichsthal
53.66,9873,4814,5059,184,Oelsnitz/Vogtl.
46.73,9857,4763,5094,211,Bad König
18.62,9833,4856,4977,528,Osthofen
78.64,9833,4832,5001,125,Fürstenau
62.23,9832,4891,4941,158,Heilsbronn
33.78,9829,4838,4991,291,Bad Liebenzell
106.6,9799,4828,4971,92,Altlandsberg
109.95,9785,4988,4797,89,Bockenem
55.21,9785,4656,5129,177,Pasewalk
97.01,9775,4792,4983,101,Laubach
113.24,9754,4928,4826,86,Dassel
159.2,9747,4780,4967,61,Visselhövede
127.66,9706,4795,4911,76,Wettin-Löbejün
122.34,9700,5008,4692,79,Hemau
140.65,9692,4634,5058,69,Bleckede
34.89,9689,4792,4897,278,Brandis
271.73,9676,4787,4889,36,Oberharz am Brocken
40.95,9672,4765,4907,236,Großröhrsdorf
279.53,9666,4779,4887,35,Klötze
19.93,9655,4722,4933,484,Bad Breisig
50.51,9649,4535,5114,191,Grimmen
51.88,9625,4805,4820,186,Wertingen
60.25,9622,4695,4927,160,Miltenberg
89.46,9588,4621,4967,107,Lüchow (Wendland)
207.44,9585,4794,4791,46,Luckau
13.65,9560,4705,4855,700,Töging a.Inn
88.24,9537,4667,4870,108,Sebnitz
90.85,9519,4623,4896,105,Bad Gandersheim
43.71,9518,4761,4757,218,Runkel
98.73,9506,4772,4734,96,Nittenau
180.72,9491,4669,4822,53,Storkow (Mark)
46.3,9479,4666,4813,205,Zwenkau
113.6,9476,4703,4773,83,Ohrdruf
77.13,9472,4693,4779,123,Rain
12.65,9461,4465,4996,748,Wilkau-Haßlau
117.02,9441,4732,4709,81,Werneuchen
15.88,9439,4589,4850,594,Höhr-Grenzhausen
63.08,9435,4646,4789,150,Ilsenburg (Harz)
231.14,9421,4529,4892,41,Osterburg (Altmark)
32.45,9407,4730,4677,290,Obernkirchen
34.27,9403,4788,4615,274,Ichenhausen
26.69,9400,4600,4800,352,Kandel
70.49,9398,4640,4758,133,Tecklenburg
75.69,9395,4560,4835,124,Hohenmölsen
18.32,9373,4489,4884,512,Heiligenhafen
80.33,9366,4587,4779,117,Rehau
80.56,9345,4818,4527,116,Freystadt
13.22,9313,4465,4848,704,Vallendar
3.99,9306,4788,4518,2332,Weißenthurm
18.75,9305,4645,4660,496,Eisenberg (Pfalz)
59.96,9301,4767,4534,155,Ochsenhausen
88.64,9298,4590,4708,105,Lügde
54.88,9294,4562,4732,169,Wunsiedel
70.13,9279,4586,4693,132,Bad Griesbach i.Rottal
237.09,9279,4587,4692,39,Kemberg
55.01,9277,4714,4563,169,Bad Schussenried
76.73,9273,4571,4702,121,Steinbach-Hallenberg
72.19,9269,4552,4717,128,Torgelow
138.88,9253,4513,4740,67,Bad Liebenwerda
55.99,9252,4613,4639,165,Borgholzhausen
47.81,9252,4605,4647,194,Elze
41.71,9214,4765,4449,221,Waldheim
115.19,9187,4671,4516,80,Elsfleth
23.57,9182,4526,4656,390,Laufenburg (Baden)
47.41,9169,4340,4829,193,Sassnitz
53.82,9144,4395,4749,170,Niesky
78.26,9127,4515,4612,117,Auerbach i.d.OPf.
59.09,9120,4514,4606,154,Breckerfeld
157.38,9114,4422,4692,58,Kyritz
23.75,9108,4472,4636,383,Mendig
114.31,9086,4477,4609,79,Zörbig
131.18,9063,4592,4471,69,Berching
36.6,9062,4532,4530,248,Neuötting
149.34,9044,4478,4566,61,Zahna-Elster
82.57,9030,4599,4431,109,Furtwangen im Schwarzwald
17.37,9023,4446,4577,519,Reinfeld (Holstein)
45.07,9007,4405,4602,200,Hemmoor
67.07,8998,4558,4440,134,Furth im Wald
85.57,8995,4454,4541,105,Bad Lauchstädt
22.79,8980,4280,4700,394,Zschopau
41.16,8978,4381,4597,218,Zwiesel
86.06,8971,4349,4622,104,Neustadt an der Orla
104.53,8956,4479,4477,86,Wetter (Hessen)
35.98,8919,4188,4731,248,Plön
45.17,8918,4539,4379,197,Vohburg a.d.Donau
46.33,8908,4373,4535,192,Brand-Erbisdorf
39.6,8902,4370,4532,225,Florstadt
14.6,8888,4391,4497,609,Hallstadt
24.82,8884,4393,4491,358,Obernburg a.Main
54.7,8872,4393,4479,162,Ortenberg
42.54,8844,4338,4506,208,Bersenbrück
108.22,8815,4488,4327,81,Neuhaus am Rennweg
39.71,8811,4294,4517,222,Naunhof
22.7,8796,4332,4464,387,Waldenbuch
60.19,8789,4430,4359,146,Volkach
108.21,8788,4459,4329,81,Schleiz
10.71,8786,4193,4593,820,Bad Bergzabern
97.83,8782,4268,4514,90,Raguhn-Jeßnitz
11.12,8727,4322,4405,785,Rauenberg
76.22,8725,4417,4308,114,Meßkirch
49.6,8713,4472,4241,176,Möckmühl
43.33,8683,4177,4506,200,Kappeln
87.3,8682,4213,4469,99,Ballenstedt
41.18,8681,4127,4554,211,Barth
149.01,8678,4198,4480,58,Herzberg (Elster)
138.94,8673,4537,4136,62,Borgentreich
34.88,8648,4276,4372,248,Wissen
85.87,8638,4175,4463,101,Ueckermünde
19.34,8631,4234,4397,446,Nierstein
28.58,8630,4283,4347,302,Staufenberg
90.11,8616,4368,4248,96,Rottenburg a.d.Laaber
25.51,8591,4258,4333,337,Großbottwar
103.95,8580,4162,4418,83,Tirschenreuth
28.15,8566,4310,4256,304,Neuenbürg
23.32,8553,4045,4508,367,Staufen im Breisgau
16.75,8553,4254,4299,511,Wörrstadt
62.47,8544,4283,4261,137,Viechtach
150.36,8536,4357,4179,57,Doberlug-Kirchhain
18.08,8534,4204,4330,472,Kuppenheim
7.49,8527,4411,4116,1138,Hermsdorf
16.53,8523,4118,4405,516,Kirn
59.46,8522,4231,4291,143,Barntrup
47.07,8459,4150,4309,180,Teterow
62.26,8456,4127,4329,136,Kandern
20.13,8447,4154,4293,420,Bönnigheim
84.07,8447,4146,4301,100,Colditz
39.76,8443,4164,4279,212,Kirchen (Sieg)
51.74,8441,4165,4276,163,Hainichen
99.03,8431,4238,4193,85,Mücheln (Geiseltal)
110.14,8431,4363,4068,77,Neunburg vorm Wald
96.93,8422,4180,4242,87,Lützen
120.26,8408,4167,4241,70,Stadtilm
58.72,8372,4130,4242,143,Helmbrechts
73.75,8370,4170,4200,113,Bad Sooden-Allendorf
63.36,8340,4118,4222,132,Penig
30.28,8339,4044,4295,275,Lauter-Bernsbach
81.66,8325,4183,4142,102,Herrieden
76.62,8316,4122,4194,109,Dannenberg (Elbe)
18.81,8313,4128,4185,442,Kellinghusen
144.61,8309,4185,4124,57,Mansfeld
46.27,8307,4038,4269,180,Premnitz
15.34,8305,4009,4296,541,Landstuhl
81.86,8298,4049,4249,101,Großräschen/Rań
128.41,8297,4216,4081,65,Willebadessen
36.41,8295,4074,4221,228,Zell am Harmersbach
33.01,8284,4068,4216,251,Bad Herrenalb
24.2,8282,4092,4190,342,Dornstetten
60.04,8276,4098,4178,138,Schieder-Schwalenberg
77.9,8272,3945,4327,106,Beeskow
112.1,8272,4162,4110,74,Arnstein
63.73,8229,3995,4234,129,Grafenau
49.02,8220,4047,4173,168,Daun
26.33,8208,4040,4168,312,Knittlingen
70.02,8207,3998,4209,117,Bad Lausick
39.85,8191,4173,4018,206,Bützow
78.09,8177,4052,4125,105,Leisnig
43.01,8167,4021,4146,190,Ramstein-Miesenbach
94.1,8161,4038,4123,87,Bad Sulza
11.96,8155,3891,4264,682,Simmern/ Hunsrück
125.78,8115,4095,4020,65,Könnern
126.05,8108,4089,4019,64,Medebach
12.15,8108,3943,4165,667,Ransbach-Baumbach
36.8,8106,3977,4129,220,Weida
16.17,8084,3738,4346,500,Kühlungsborn
57.25,8078,3947,4131,141,Calbe (Saale)
11.81,8074,4040,4034,684,Baiersdorf
58.53,8071,4007,4064,138,Hüfingen
26.36,8067,3888,4179,306,Kirchheimbolanden
116.07,8065,4135,3930,69,Oranienbaum-Wörlitz
23.55,8055,4045,4010,342,Oberkochen
161.23,8053,3952,4101,50,Bad Schmiedeberg
42.14,8053,3939,4114,191,Lauta
118.51,8049,4121,3928,68,Neresheim
54.06,8026,4047,3979,148,Gundelfingen a.d.Donau
154.04,8023,4002,4021,52,Barby
31.08,8013,3850,4163,258,Schweich
39.56,7979,3878,4101,202,Kirchberg
328.14,7971,3924,4047,24,Rheinsberg
81.67,7968,3988,3980,98,Teuchern
38.23,7938,3948,3990,208,Teublitz
290.7,7899,3952,3947,27,Bismark (Altmark)
145.9,7893,4015,3878,54,Altenberg
80.93,7881,3931,3950,97,Weikersheim
64.43,7860,3907,3953,122,Gerolstein
45.8,7859,3690,4169,172,Bad Düben
40.5,7847,3838,4009,194,Elsterwerda
30.49,7794,3836,3958,256,Lößnitz
88.02,7787,3928,3859,88,Löffingen
22.29,7771,3770,4001,349,Lugau/Erzgeb.
209.54,7745,3814,3931,37,Kremmen
77.33,7706,3798,3908,100,Oederan
48.81,7697,3720,3977,158,Bad Liebenstein
163.49,7695,3791,3904,47,Calau/Kalawa
43.74,7679,3745,3934,176,Treuen
50.44,7669,3701,3968,152,Klingenthal
57.32,7667,3916,3751,134,Parsberg
32.16,7661,3982,3679,238,Leipheim
31.06,7654,3629,4025,246,Falkenstein/Vogtl.
111.28,7653,3887,3766,69,Sontra
79.06,7651,3806,3845,97,Seeland
111.42,7645,3778,3867,69,Vetschau/Spreewald / Wětošow/Błota
84.03,7644,3756,3888,91,Hardegsen
74.91,7637,3783,3854,102,Vohenstrauß
37.04,7618,3704,3914,206,Naila
54.02,7614,3779,3835,141,Radeburg
20.63,7612,3698,3914,369,Saarburg
44.76,7605,4272,3333,170,Horstmar
75.28,7601,3771,3830,101,Elzach
19.38,7575,3714,3861,391,Bad Wimpfen
30.76,7556,3763,3793,246,Breuberg
93.11,7556,3813,3743,81,Münnerstadt
33.55,7555,3553,4002,225,Otterndorf
150.47,7550,3787,3763,50,Allstedt
38.44,7550,3799,3751,196,Gundelsheim
70.17,7542,3598,3944,107,Groitzsch
35.28,7541,3808,3733,214,Laufen
7.1,7535,3651,3884,1061,Oppenheim
21.67,7517,3536,3981,347,Esens
30.89,7511,4100,3411,243,Hermeskeil
165.02,7510,3722,3788,46,Harzgerode
158.99,7495,3729,3766,47,Belgern-Schildau
62.15,7493,3702,3791,121,Bad Kötzting
88.04,7485,3787,3698,85,Homberg (Ohm)
32.08,7451,3732,3719,232,Renchen
33.2,7428,3565,3863,224,Bad Sachsa
212.43,7422,3611,3811,35,Treuenbrietzen
55.32,7385,3562,3823,133,Bad Berka
95.01,7365,3775,3590,78,Ebern
83.43,7349,3654,3695,88,Pockau-Lengefeld
273.64,7348,3724,3624,27,Kalbe (Milde)
86.52,7344,3666,3678,85,Eisfeld
94.87,7344,3768,3576,77,Scheßlitz
21.26,7318,3518,3800,344,Meldorf
103.73,7309,3766,3543,70,Greding
26.76,7301,3566,3735,273,Pulsnitz
44.11,7297,3651,3646,165,Roßwein
5.66,7284,3582,3702,1287,Zwingenberg
48.63,7263,3589,3674,149,Freyung
75.24,7250,3675,3575,96,Gedern
39.87,7249,3564,3685,182,Annweiler am Trifels
18.67,7241,3581,3660,388,Haslach im Kinzigtal
13.64,7236,3686,3550,530,Birkenfeld
109.28,7231,3554,3677,66,Malchin
60.95,7228,3648,3580,119,Dettelbach
59.99,7225,3535,3690,120,Aken (Elbe)
73.08,7206,3526,3680,99,Roßleben-Wiehe
23.71,7205,3484,3721,304,Bernkastel-Kues
95.14,7200,3577,3623,76,Wriezen
28.54,7190,3552,3638,252,Immenhausen
12.77,7175,3514,3661,562,Nortorf
152.29,7135,3629,3506,47,Müncheberg
69.04,7132,3519,3613,103,Markneukirchen
36.87,7116,3428,3688,193,Friedrichroda
54.87,7115,3615,3500,130,Ilshofen
103.01,7113,3525,3588,69,Königsee
99.68,7093,3612,3481,71,Geiselhöring
46.99,7084,3457,3627,151,Lengenfeld
37.45,7073,3477,3596,189,Höchstädt a.d.Donau
92.44,7070,3526,3544,76,Am Ettersberg
13.99,7043,3437,3606,503,Gau-Algesheim
49.95,7041,3507,3534,141,Ebermannstadt
75.91,7017,3572,3445,92,Bonndorf im Schwarzwald
66.25,7014,3482,3532,106,Neukirchen
27.56,6997,3487,3510,254,Reichelsheim (Wetterau)
61.2,6996,3492,3504,114,Heringen (Werra)
112.24,6975,3400,3575,62,Eibenstock
94.05,6974,3480,3494,74,Neustadt-Glewe
18.39,6966,3444,3522,379,Gerolzhofen
82.39,6956,3592,3364,84,Moringen
75.87,6952,3598,3354,92,Schelklingen
25.27,6931,3425,3506,274,Böhlen
28.68,6930,3468,3462,242,Polch
18.75,6922,3460,3462,369,Dietenheim
64.7,6920,3455,3465,107,Vilseck
59.18,6878,3414,3464,116,Schwarzenbach a.d.Saale
17.89,6838,3451,3387,382,Edenkoben
28.94,6834,3428,3406,236,Gröditz
67.47,6830,3440,3390,101,Volkmarsen
59.47,6807,3395,3412,114,Uffenheim
54.71,6797,3321,3476,124,Geithain
7.9,6795,3350,3445,860,Kahla
101.17,6781,3402,3379,67,Waldmünchen
115.7,6780,3378,3402,59,Waldeck
15.69,6768,3298,3470,431,Rodalben
93.65,6758,3305,3453,72,Ketzin/Havel
95.93,6735,3306,3429,70,Hecklingen
102.87,6730,3345,3385,65,Gerbstedt
47.86,6722,3390,3332,140,Neuenstein
101.71,6710,3442,3268,66,Boxberg
216.21,6710,3241,3469,31,Grafenwöhr
272.03,6708,3402,3306,25,Jerichow
54.4,6700,3319,3381,123,Hartha
25.4,6697,3386,3311,264,Maulbronn
47.32,6694,3421,3273,141,Osterburken
24.18,6684,3239,3445,276,Stadtroda
23.71,6674,3253,3421,281,Bad Brückenau
271.13,6666,3344,3322,25,Arendsee (Altmark)
66.53,6666,3290,3376,100,Waldsassen
17.99,6661,3301,3360,370,Herdorf
39.38,6644,3263,3381,169,Mitterteich
77.65,6643,3294,3349,86,Bad Rodach
104.8,6638,3346,3292,63,Buttstädt
113.75,6609,3281,3328,58,Blankenhain
86.55,6609,3254,3355,76,Zierenberg
45.41,6605,3474,3131,145,Rötha
10.98,6603,3187,3416,601,Altenkirchen (Westerwald)
51.11,6590,3338,3252,129,Rosenfeld
48.78,6590,3249,3341,135,Pegau
95.64,6581,3347,3234,69,Glashütte
122.45,6571,3331,3240,54,Römhild
44.71,6558,3182,3376,147,Malchow
114.9,6555,3272,3283,57,Laage
45.05,6551,3225,3326,145,Artern
141.79,6550,3217,3333,46,Friedland
61.07,6543,3292,3251,107,Neumarkt-Sankt Veit
20.03,6526,3257,3269,326,Thannhausen
15.61,6525,3272,3253,418,Rodenberg
11.71,6495,3225,3270,555,Heitersheim
150.12,6494,3187,3307,43,Havelberg
54.18,6484,3185,3299,120,Bad Sobernheim
89.52,6465,3308,3157,72,Kölleda
40.6,6459,3167,3292,159,Burgkunstadt
53.57,6427,3246,3181,120,Wassertrüdingen
25.24,6422,3216,3206,254,Beilstein
80.08,6418,3225,3193,80,Wittenburg
17.98,6417,3098,3319,357,Linz am Rhein
226.59,6403,3187,3216,28,Annaburg
26.87,6396,3094,3302,238,Rodewisch
17.43,6396,3212,3184,367,Neuffen
16.27,6391,3221,3170,393,Güglingen
39.68,6381,3058,3323,161,Glücksburg (Ostsee)
62.36,6349,3166,3183,102,Nabburg
36.12,6336,3163,3173,175,Zell im Wiesental
73.75,6315,3194,3121,86,Geisingen
21.13,6310,3128,3182,299,Klingenberg a.Main
79.2,6304,3189,3115,80,Trochtelfingen
28.59,6303,3154,3149,220,Dohna
52.97,6298,3208,3090,119,Gammertingen
9.95,6279,3108,3171,631,Bad Marienberg (Westerwald)
59.86,6257,3095,3162,105,Bernsdorf
78.7,6257,3268,2989,80,Dietfurt a.d.Altmühl
77.67,6255,3171,3084,81,Werra-Suhl-Tal
122.33,6254,3128,3126,51,Arnstein
68.12,6248,3177,3071,92,Windsbach
64.56,6242,3227,3015,97,Alpirsbach
21.43,6236,2959,3277,291,Hachenburg
100.3,6230,3139,3091,62,Riedenburg
37.59,6226,3091,3135,166,Großalmerode
44.91,6219,3098,3121,138,Dornhan
37.36,6218,3137,3081,166,Vogtsburg im Kaiserstuhl
97.71,6214,3202,3012,64,Spangenberg
82.16,6205,3064,3141,76,Falkenberg/Elster
79.71,6189,3232,2957,78,Nieheim
69.51,6176,3018,3158,89,Bad Königshofen i.Grabfeld
20.09,6173,3021,3152,307,Bad Hönningen
12.07,6168,2904,3264,511,Meersburg
116.27,6166,3020,3146,53,Plau am See
74.69,6146,2946,3200,82,Lübz
60.92,6120,3043,3077,100,Biesenthal
70.24,6087,3172,2915,87,Schlüsselfeld
62.14,6058,3055,3003,97,Bräunlingen
14.37,6057,3222,2835,422,Kusel
28.92,6029,3055,2974,208,Haiterbach
31.98,6026,3021,3005,188,Dierdorf
121.68,6022,2944,3078,49,Gransee
31.96,5993,2981,3012,188,Geislingen
35.62,5992,2990,3002,168,Bad Blankenburg
26.31,5990,2818,3172,228,Norderney
4.83,5979,2849,3130,1238,Marne
24.34,5978,3005,2973,246,Schirgiswalde-Kirschau
72.01,5970,3025,2945,83,Tittmoning
10.79,5961,2850,3111,552,Thalheim/Erzgeb.
95.29,5953,2991,2962,62,An der Schmücke
9.93,5950,2912,3038,599,Neustadt a.d.Waldnaab
105.21,5947,3084,2863,57,Schrozberg
31.63,5892,2886,3006,186,Münzenberg
79.57,5892,2958,2934,74,Nienburg (Saale)
80.76,5882,2960,2922,73,Großbreitenbach
18.48,5868,2851,3017,318,Westerburg
31.6,5860,2855,3005,185,Wemding
75.96,5855,3119,2736,77,Nottertal-Heilinger Höhen
28.66,5847,2898,2949,204,Leun
9.75,5826,2828,2998,598,Bredstedt
24.69,5815,2865,2950,236,Neubulach
74.13,5814,2895,2919,78,Herrnhut
14.68,5812,2821,2991,396,Oberlungwitz
55.08,5794,2890,2904,105,Mügeln
41.02,5768,2880,2888,141,Stavenhagen
36.07,5760,2866,2894,160,Hausach
8.41,5759,2839,2920,685,Kastellaun
94.41,5748,2937,2811,61,Kaltennordheim
72.46,5744,2904,2840,79,Treffurt
213.85,5739,2799,2940,27,Fürstenberg/Havel
23.76,5716,2720,2996,241,Rochlitz
56.79,5714,2848,2866,101,Kemnath
24.92,5713,2830,2883,229,Stadtoldendorf
22.25,5713,2833,2880,257,Grünhain-Beierfeld
67.98,5712,2839,2873,84,Wolfach
86.82,5711,2843,2868,66,Greußen
25.57,5708,2805,2903,223,Waibstadt
49.84,5706,2815,2891,114,Grebenstein
10.11,5703,2825,2878,564,Wirges
84.07,5689,2819,2870,68,Leutershausen
49.68,5687,2790,2897,114,Brotterode-Trusetal
30.61,5678,2877,2801,185,Niedenstein
42.73,5670,2711,2959,133,Seelow
32.91,5668,2882,2786,172,Neudenau
74.96,5666,2775,2891,76,Hirschau
48.92,5663,2765,2898,116,Bad Lobenstein
31.35,5662,2803,2859,181,Traben-Trarbach
73.16,5652,2855,2797,77,Harburg (Schwaben)
61.02,5648,2768,2880,93,Wittichenau / Kulow
39.74,5639,2774,2865,142,Schöppenstedt
33.44,5637,2772,2865,169,Schwarzheide
35.67,5631,2810,2821,158,Zeil a.Main
29.05,5618,2725,2893,193,Bodenwerder
48.41,5614,2777,2837,116,Abenberg
14.3,5608,3010,2598,392,Heimsheim
56.03,5599,2737,2862,100,Mellrichstadt
64.71,5585,2834,2751,86,Battenberg (Eder)
72.27,5573,2756,2817,77,Grabow
22.86,5563,2811,2752,243,Prüm
175.66,5553,2828,2725,32,Velburg
15.86,5551,2747,2804,350,Hagenbach
69.33,5544,2844,2700,80,Monheim
60.89,5540,2776,2764,91,Stolpen
40.81,5538,2791,2747,136,Eltmann
143.9,5534,2789,2745,38,Drebkau/Drjowk
89.34,5521,2737,2784,62,Gersfeld (Rhön)
93.2,5518,2811,2707,59,Stühlingen
91.9,5518,2795,2723,60,Zarrentin am Schaalsee
88.72,5498,2744,2754,62,Bad Gottleuba-Berggießhübel
31.65,5495,2739,2756,174,Braunlage
46.48,5489,2745,2744,118,Ingelfingen
69.41,5488,2689,2799,79,Ellrich
6.15,5479,2594,2885,891,Lütjenburg
71.23,5467,2731,2736,77,Tharandt
61.63,5465,2741,2724,89,Großschirma
47.76,5459,2649,2810,114,Gadebusch
32.11,5438,2626,2812,169,Otterberg
13.07,5422,2688,2734,415,Munderkingen
81.43,5414,2794,2620,66,Külsheim
89.08,5413,2726,2687,61,Wasungen
36.83,5395,2699,2696,146,Rockenhausen
16.59,5381,2675,2706,324,Mahlberg
21.09,5378,2625,2753,255,Lindenfels
82.55,5360,2686,2674,65,Diemelstadt
34.22,5359,2684,2675,157,Oettingen i.Bay.
21.18,5346,2701,2645,252,Cochem
43.84,5313,2842,2471,121,Adelsheim
76.61,5306,2604,2702,69,Burg Stargard
38.09,5302,2717,2585,139,Forchtenberg
30.77,5298,2574,2724,172,Dornburg-Camburg
13.03,5281,2562,2719,405,Waldmohr
55.67,5272,2670,2602,95,Spalt
51.48,5266,2609,2657,102,Pfreimd
38.55,5254,2588,2666,136,Ruhla
29.04,5243,2580,2663,181,Kitzscher
73.29,5225,2655,2570,71,Pottenstein
53.07,5213,2604,2609,98,Altentreptow
56.34,5203,2606,2597,92,Hofheim i.UFr.
48.97,5193,2634,2559,106,Freren
52.24,5148,2615,2533,99,Wörth a.d.Donau
58.67,5126,2385,2741,87,Hitzacker (Elbe)
64.87,5111,2558,2553,79,Creußen
104.11,5104,2594,2510,49,Falkenstein/Harz
19.13,5098,2540,2558,266,Ronneburg
66.32,5095,2529,2566,77,Naumburg
43.19,5094,2560,2534,118,Arzberg
135.61,5092,2584,2508,38,Uebigau-Wahrenbrück
67.56,5088,2529,2559,75,Erbendorf
38.29,5061,2413,2648,132,Schwaan
27.62,5051,2505,2546,183,Lichtenau
8.16,5041,2440,2601,618,Unkel
30.98,5012,2407,2605,162,Borkum
30.68,5012,2390,2622,163,Röbel/Müritz
43.9,5000,2500,2500,114,Amöneburg
62.42,4985,2519,2466,80,Oberviechtach
36.37,4984,2500,2484,137,Windischeschenbach
69.75,4962,2484,2478,71,Todtnau
13.59,4954,2381,2573,365,Freinsheim
8.05,4951,2406,2545,615,Emmelshausen
45.12,4945,2544,2401,110,Scheinfeld
44.43,4940,2444,2496,111,Tönning
33.33,4926,2543,2383,148,Triberg im Schwarzwald
29.81,4925,2449,2476,165,Niederstotzingen
104.05,4922,2534,2388,47,Niederstetten
72.98,4914,2463,2451,67,Oppenau
64.36,4913,2499,2414,76,Marienmünster
18.9,4912,2406,2506,260,Thum
40.87,4905,2471,2434,120,Lauchheim
44.41,4903,2427,2476,110,Vacha
80.66,4884,2425,2459,61,Hollfeld
62.03,4873,2428,2445,79,Tengen
162.57,4863,2383,2480,30,Dahme/Mark
78.06,4843,2406,2437,62,Iphofen
23.25,4834,2487,2347,208,Schömberg
67.55,4816,2425,2391,71,Kröpelin
71.94,4807,2402,2405,67,Geisa
90.14,4803,2414,2389,53,Weismain
15.88,4791,2348,2443,302,Wörth a.Main
62.64,4789,2375,2414,76,Reichenbach/O.L.
88.22,4785,2320,2465,54,Eggesin
69.37,4785,2380,2405,69,Trendelburg
18.27,4762,2383,2379,261,Groß-Bieberau
75.86,4760,2263,2497,63,Crivitz
17.04,4756,2218,2538,279,Wilthen
67.7,4756,2364,2392,70,Bischofsheim i.d.Rhön
31.89,4752,2385,2367,149,Vellberg
66.61,4745,2314,2431,71,Lommatzsch
69.23,4734,2264,2470,68,Müllrose
23.75,4710,2388,2322,198,Bad Buchau
42.97,4694,2288,2406,109,Adorf/Vogtl.
107.2,4693,2312,2381,44,Seehausen (Altmark)
58.64,4688,2371,2317,80,Heideck
17.55,4687,2333,2354,267,Nassau
64.13,4682,2307,2375,73,Pausa-Mühltroff
52.19,4674,2298,2376,90,Schönberg
140.52,4673,2393,2280,33,Marlow
78.48,4664,2284,2380,59,Königsbrück
35.13,4646,2261,2385,132,Eschenbach i.d.OPf.
52.9,4643,2432,2211,88,Krautheim
79.98,4625,2365,2260,58,Herbstein
120.16,4621,2465,2156,38,Lübtheen
67.32,4615,2303,2312,69,Rauschenberg
69.73,4602,2355,2247,66,Amt Creuzburg
66.91,4582,2336,2246,68,Heringen/Helme
46.69,4579,2250,2329,98,Freyburg (Unstrut)
60.45,4579,2343,2236,76,Tann (Rhön)
40.93,4567,2453,2114,112,Kirchberg an der Jagst
117.23,4565,2349,2216,39,Creglingen
69.19,4538,2167,2371,66,Baumholder
24.97,4535,2214,2321,182,Wachenheim an der Weinstraße
40.76,4535,2232,2303,111,Dahn
38.26,4526,2279,2247,118,Bad Berneck i.Fichtelgebirge
15.89,4521,2162,2359,285,Ehrenfriedersdorf
40.38,4520,2300,2220,112,Gerabronn
142.14,4500,2245,2255,32,Liebenwalde
66.69,4492,2186,2306,67,Putbus
65.35,4488,2340,2148,69,Hallenberg
23.38,4482,2206,2276,192,Augustusburg
30.73,4467,2239,2228,145,Rabenau
36.7,4458,2191,2267,121,Hartenstein
13.49,4452,2131,2321,330,Peitz/Picnjo
13.05,4445,2158,2287,341,Nastätten
18.14,4426,2225,2201,244,Rennerod
87.48,4399,2150,2249,50,Strasburg (Uckermark)
2.71,4389,2166,2223,1620,Wilster
28.91,4381,2130,2251,152,Dransfeld
22.49,4376,2196,2180,195,Schönau
16.36,4366,2193,2173,267,Rheinböllen
8.08,4355,2048,2307,539,Wyk auf Föhr
64.96,4349,2176,2173,67,Heimbach
41.64,4318,2155,2163,104,Tambach-Dietharz/Thür. Wald
118.01,4318,2117,2201,37,Dargun
233.83,4314,2215,2099,18,Baruth/Mark
36.7,4301,2098,2203,117,Schwarzenbach a.Wald
72.41,4292,2179,2113,59,Rothenburg/O.L.
66.34,4287,2140,2147,65,Pressath
63.41,4277,2182,2095,67,Schnaittenbach
27.75,4274,2049,2225,154,Selbitz
54.45,4256,2135,2121,78,Hornberg
89.91,4254,2135,2119,47,Loitz
86.19,4248,2139,2109,49,Brück
37.83,4248,2155,2093,112,Gräfenberg
50.32,4248,2036,2212,84,Gefrees
60.37,4233,2074,2159,70,Waldershof
19.58,4223,2083,2140,216,Daaden
26.41,4213,2134,2079,160,Neckarbischofsheim
17.69,4213,2154,2059,238,Niedernhall
46.88,4212,2077,2135,90,Wanfried
164.17,4209,2080,2129,26,Woldegk
54.41,4207,2052,2155,77,St. Blasien
71.87,4201,2085,2116,58,Dahlen
96.53,4200,2096,2104,44,Waldkappel
18.05,4177,2075,2102,231,Kirchberg (Hunsrück)
30.05,4166,2027,2139,139,Geringswalde
8.32,4131,2021,2110,497,Lambrecht (Pfalz)
44.95,4117,2074,2043,92,Zell (Mosel)
96.77,4114,2084,2030,43,Lichtenfels
22.05,4101,2092,2009,186,Allendorf (Lumda)
17.24,4099,2092,2007,238,Neckarsteinach
32.14,4065,2033,2032,126,Baunach
115.56,4053,2014,2039,35,Penzlin
31.25,4045,1993,2052,129,Ellingen
28.34,4027,1987,2040,142,Lunzenau
66.96,4021,2026,1995,60,Dassow
8.45,4020,1940,2080,476,Hoya
54.43,4019,2041,1978,74,Lorch
25.14,4019,1964,2055,160,Neubukow
24.51,4019,1973,2046,164,Tessin
27.51,3974,2011,1963,144,Neukloster
22.74,3967,1971,1996,174,Tegernsee
36.23,3962,1924,2038,109,Güsten
20.16,3961,2029,1932,196,Marktbreit
64.32,3951,1996,1955,61,Pappenheim
67.69,3943,1914,2029,58,Sternberg
72.53,3942,2001,1941,54,Seßlach
64.65,3941,2001,1940,61,Kindelbrück
25.06,3923,1934,1989,157,Waldenburg
58.65,3915,1961,1954,67,Gemünden (Wohra)
50.9,3914,1913,2001,77,Amorbach
158.28,3871,1888,1983,24,Mirow
26.37,3845,1922,1923,146,Regis-Breitingen
30.51,3821,1887,1934,125,Wolkenstein
15.36,3818,1910,1908,249,Speicher
26.54,3773,1803,1970,142,Deidesheim
35.05,3771,1888,1883,108,Trebsen/Mulde
29.59,3749,1850,1899,127,Johanngeorgenstadt
55.33,3746,1896,1850,68,Weißensee
37.22,3737,1807,1930,100,Ruhland
30.27,3726,1787,1939,123,Strehla
34.21,3725,1836,1889,109,Schiltach
12.51,3718,1811,1907,297,Netzschkau
70.47,3709,1902,1807,53,Vöhrenbach
34.76,3701,1857,1844,106,Freudenberg
25.1,3701,1784,1917,147,Elsterberg
14.85,3701,1849,1852,249,Bad Karlshafen
44.72,3696,1863,1833,83,Grünsfeld
15.38,3685,1817,1868,240,Bad Muskau / Mužakow
20.34,3672,1783,1889,181,Bad Köstritz
44.59,3638,1799,1839,82,Rehna
33.15,3631,1822,1809,110,Triptis
19.77,3617,1718,1899,183,Bad Elster
61.88,3614,1803,1811,58,Königsberg i.Bay.
19.12,3610,1758,1852,189,Seifhennersdorf
26.35,3587,1767,1820,136,Steinach
21.74,3570,1761,1809,164,Mühlheim an der Donau
23.92,3568,1783,1785,149,Eschershausen
5.13,3545,1707,1838,691,Wesselburen
59.89,3525,1749,1776,59,Gröningen
30.68,3523,1725,1798,115,Goldkronach
28.74,3515,1763,1752,122,Ulmen
9.7,3505,1753,1752,361,Owen
12.93,3500,1672,1828,271,Lucka
20.68,3491,1765,1726,169,Wildenfels
89.2,3481,1729,1752,39,Mühlberg/Elbe
75.87,3477,1680,1797,46,Neustadt (Dosse)
30.85,3473,1702,1771,113,Hirschhorn (Neckar)
9.01,3466,1637,1829,385,Stromberg
42.3,3464,1717,1747,82,Burgbernheim
14.07,3459,1687,1772,246,Gößnitz
27.77,3457,1643,1814,124,Münstermaifeld
87.36,3443,1708,1735,39,Krakow am See
23.46,3436,1713,1723,146,Löwenstein
121.68,3430,1731,1699,28,Joachimsthal
46.78,3409,1671,1738,73,Bad Schandau
87.35,3389,1689,1700,39,Tanna
64.72,3372,1627,1745,52,Goldberg
8.16,3370,1695,1675,413,Oberriexingen
40.85,3358,1660,1698,82,Ostheim v.d.Rhön
25.98,3355,1623,1732,129,Schwarzatal
55.91,3332,1655,1677,60,Auma-Weidatal
66.67,3328,1685,1643,50,Rötz
112.74,3322,1698,1624,29,Heldburg
18.56,3317,1591,1726,179,Geyer
58.74,3315,1622,1693,56,Ludwigsstadt
72.05,3292,1621,1671,46,Saalburg-Ebersdorf
44.45,3271,1648,1623,74,Warin
8.18,3267,1582,1685,399,Kaisersesch
23.1,3266,1634,1632,141,Kranichfeld
25.17,3241,1669,1572,129,Bad Teinach-Zavelstein
20.62,3230,1599,1631,157,Hillesheim
39.57,3229,1588,1641,82,Welzow/Wjelcej
48.87,3229,1661,1568,66,Prichsenstadt
25.47,3221,1540,1681,126,Wolframs-Eschenbach
81.97,3212,1610,1602,39,Havelsee
40.82,3199,1574,1625,78,Kelbra (Kyffhäuser)
44.02,3199,1597,1602,73,Schalkau
29.33,3195,1557,1638,109,Egeln
43.52,3193,1584,1609,73,Berga/Elster
64.64,3183,1592,1591,49,Hohnstein
39.8,3183,1591,1592,80,Stadtsteinach
119.29,3182,1610,1572,27,Sonnewalde
18.72,3173,1550,1623,169,Lauscha
52.0,3173,1596,1577,61,Bernstadt a. d. Eigen
22.91,3169,1573,1596,138,Neusalza-Spremberg
19.19,3165,1517,1648,165,Schönwald
22.47,3161,1583,1578,141,Fridingen an der Donau
48.48,3144,1550,1594,65,Kirchenlamitz
54.42,3142,1563,1579,58,Lebus
111.98,3139,1522,1617,28,Lychen
7.07,3135,1493,1642,443,Eibelstadt
44.44,3128,1466,1662,70,Klütz
15.79,3118,1505,1613,197,Döbern/Derbno
79.91,3114,1537,1577,39,Kirtorf
57.93,3104,1622,1482,54,Waischenfeld
26.07,3083,1561,1522,118,Merkendorf
74.41,3077,1608,1469,41,Bärnau
27.19,3070,1516,1554,113,Bürgel
50.96,3068,1552,1516,60,Weißenberg / Wóspork
25.46,3067,1499,1568,120,Nebra (Unstrut)
31.54,3040,1556,1484,96,Waldenburg
42.23,3031,1516,1515,72,Weißenstadt
16.31,3031,1474,1557,186,Rhens
89.65,3029,1503,1526,34,Wesenberg
65.61,3019,1501,1518,46,Ulrichstein
8.7,3014,1475,1539,346,Selters (Westerwald)
58.51,3000,1490,1510,51,Hatzfeld (Eder)
174.15,2985,1513,1472,17,Friedland
156.16,2973,1508,1465,19,Schönewalde
48.88,2970,1448,1522,61,Liebenau
19.5,2969,1495,1474,152,Braubach
55.04,2969,1437,1532,54,Schöneck/Vogtl.
60.57,2967,1477,1490,49,Dömitz
55.97,2958,1519,1439,53,Ravenstein
57.65,2955,1489,1466,51,Gützkow
65.47,2941,1500,1441,45,Lindow (Mark)
72.32,2940,1473,1467,41,Wurzbach
18.56,2916,1447,1469,157,Adenau
23.17,2913,1461,1452,126,Sankt Goar
15.45,2902,1416,1486,188,Münchenbernsdorf
18.08,2899,1423,1476,160,Oberwesel
57.29,2886,1424,1462,50,Frankenau
35.48,2878,1401,1477,81,Marktleuthen
41.11,2867,1391,1476,70,Gnoien
30.71,2846,1405,1441,93,Jarmen
10.33,2836,1370,1466,275,Meisenheim
3.06,2814,1360,1454,920,Garding
27.5,2805,1438,1367,102,Schillingsfürst
22.74,2769,1324,1445,122,Sulzburg
31.28,2768,1416,1352,88,Laucha an der Unstrut
45.74,2749,1356,1393,60,Elterlein
30.18,2748,1366,1382,91,Wustrow (Wendland)
20.18,2739,1360,1379,136,Themar
44.54,2730,1378,1352,61,Ebeleben
32.63,2697,1374,1323,83,Elstra / Halštrow
54.97,2694,1365,1329,49,Tribsees
58.98,2690,1351,1339,46,Frauenstein
54.43,2690,1294,1396,49,Romrod
27.22,2620,1301,1319,96,Brüel
49.93,2602,1314,1288,52,Bad Bibra
53.43,2592,1345,1247,49,Schkölen
119.68,2589,1310,1279,22,Putlitz
23.31,2587,1287,1300,111,Lauterstein
79.38,2577,1223,1354,32,Bad Wilsnack
45.65,2566,1284,1282,56,Wallenfels
84.03,2555,1286,1269,30,Friesack
4.02,2544,1196,1348,633,Friedrichstadt
18.73,2535,1287,1248,135,Scheer
51.84,2515,1276,1239,49,Betzenstein
35.52,2514,1278,1236,71,Rastenberg
27.42,2497,1229,1268,91,Bad Tennstedt
23.72,2494,1157,1337,105,Alsleben (Saale)
67.96,2493,1222,1271,37,Ziesar
49.69,2493,1267,1226,50,Jöhstadt
63.66,2489,1253,1236,39,Golßen
14.72,2450,1221,1229,166,Schönau im Schwarzwald
32.97,2437,1184,1253,74,Schwanebeck
3.38,2429,1218,1211,719,Krempe
10.68,2427,1227,1200,227,Aach
61.88,2427,1204,1223,39,Gartz (Oder)
27.66,2399,1239,1160,87,Osterfeld
78.65,2394,1168,1226,30,Schlieben
45.22,2390,1204,1186,53,Gefell
34.08,2387,1209,1178,70,Rethem (Aller)
51.88,2382,1202,1180,46,Wegeleben
55.34,2382,1189,1193,43,Grebenau
50.28,2360,1202,1158,47,Schönsee
42.4,2351,1168,1183,55,Pleystein
12.21,2334,1163,1171,191,Mainbernheim
30.44,2319,1151,1168,76,Dommitzsch
9.18,2315,1083,1232,252,Katzenelnbogen
21.22,2272,1125,1147,107,Schlettau
36.13,2265,1144,1121,63,Eckartsberga
65.91,2256,1104,1152,34,Garz/Rügen
63.37,2256,1116,1140,36,Hayingen
23.48,2228,1102,1126,95,Ostritz
46.34,2190,1119,1071,47,Fladungen
24.08,2187,1096,1091,91,Gebesee
34.22,2186,1048,1138,64,Rerik
24.13,2147,1087,1060,89,Hirschberg
27.05,2141,1084,1057,79,Königstein/Sächs. Schw.
31.25,2134,1056,1078,68,Veringenstadt
50.71,2129,1071,1058,42,Meyenburg
51.55,2111,1068,1043,41,Rosenthal
36.12,2107,1080,1027,58,Oderberg
96.2,2066,1009,1057,21,Lenzen (Elbe)
45.11,2056,1045,1011,46,Niemegk
40.03,2051,1010,1041,51,Oberwiesenthal
8.89,2044,1005,1039,230,Lauterecken
23.41,2044,1047,997,87,Wiesensteig
7.36,2021,953,1068,275,Ortrand
9.0,2012,985,1027,224,Scheibenberg
57.52,2011,1008,1003,35,Leutenberg
22.69,1975,966,1009,87,Plaue
15.47,1973,999,974,128,Sachsenhagen
20.58,1972,987,985,96,Magdala
26.19,1941,954,987,74,Rieneck
34.25,1921,936,985,56,Teuschnitz
10.51,1920,1001,919,183,Marktsteft
13.77,1908,966,942,139,Wolfstein
26.66,1899,950,949,71,Schauenstein
48.16,1895,931,964,39,Teupitz
31.4,1886,980,906,60,Langenburg
36.42,1869,928,941,51,Gräfenthal
46.06,1859,944,915,40,Hettingen
23.35,1845,923,922,79,Bacharach
25.23,1836,961,875,73,Widdern
101.81,1835,946,889,18,Brüssow
21.34,1808,918,890,85,Velden
26.67,1764,889,875,66,Bad Sülze
78.87,1756,868,888,22,Penkun
47.97,1753,879,874,37,Neukalen
39.06,1723,836,887,44,Usedom
35.3,1702,866,836,48,Sayda
15.16,1697,879,818,112,Ornbau
23.4,1681,840,841,72,Oberhof
27.21,1673,857,816,61,Röttingen
10.57,1660,807,853,157,Ranis
10.87,1604,843,761,148,Stadtprozelten
31.67,1584,775,809,50,Rhinow
10.17,1560,790,770,153,Neuerburg
35.94,1555,810,745,43,Lehesten
10.85,1543,788,755,142,Stadt Wehlen
14.42,1493,729,764,104,Buckow (Märkische Schweiz)
28.21,1473,733,740,52,Lassan
10.06,1462,694,768,145,Manderscheid
31.14,1443,706,737,46,Arneburg
15.66,1438,709,729,92,Hohenberg a.d.Eger
9.53,1426,798,628,150,Hohenleuben
13.34,1419,710,709,106,Hornbach
17.54,1398,733,665,80,Aub
38.91,1377,684,693,35,Kroppenstedt
15.67,1365,677,688,87,Richtenberg
15.2,1353,656,697,89,Franzburg
73.03,1338,670,668,18,Lieberose
7.06,1281,653,628,181,Sankt Goarshausen
37.36,1248,642,606,33,Liebstadt
26.9,1194,653,541,44,Schwarzenborn
20.3,1145,568,577,56,Neustadt am Kulm
8.28,1070,544,526,129,Kupferberg
7.07,1066,525,541,151,Schraplau
7.47,1063,540,523,142,Orlamünde
10.15,1054,521,533,104,Obermoschel
10.75,1037,507,530,96,Clingen
9.47,1026,504,522,108,Lichtenberg
12.07,1022,517,505,85,Rothenfels
4.62,958,500,458,207,Kyllburg
53.2,933,484,449,18,Werben (Elbe)
7.33,889,427,462,121,Stößen
24.86,885,453,432,36,Märkisch Buchholz
18.56,831,393,438,45,Sandau (Elbe)
13.05,786,402,384,60,Kaub
8.25,615,303,312,75,Ziegenrück
23.7,521,259,262,22,Schnackenburg
8.67,482,253,229,56,Neumark
15.73,463,237,226,29,Ummerstadt
0.45,254,125,129,564,Arnis
