flaeche_km2,pop_insgesamt,pop_maennlich,pop_weiblich,pop_density,stadt_name,latitude,longitude
891.12,3782202,1860115,1922087,4244,Berlin,52.510885,13.3989367
755.09,1910160,936740,973420,2530,Hamburg,53.550341,10.000654
310.7,1510378,734925,775453,4861,München,48.1371079,11.5753822
405.02,1087353,527728,559625,2685,Köln,50.938361,6.959974
248.31,775790,382226,393564,3124,Frankfurt am Main,50.1106444,8.6820917
207.33,633484,316030,317454,3055,Stuttgart,48.7784485,9.1800132
217.41,631217,304616,326601,2903,Düsseldorf,51.2254018,6.7763137
297.8,619879,305443,314436,2082,Leipzig,51.3406321,12.3747329
280.71,595471,292178,303293,2121,Dortmund,51.5142273,7.4652789
210.34,586608,285411,301197,2789,Essen,51.4582235,7.0158171
318.2,577026,285270,291756,1813,Bremen,53.0758196,8.8071646
328.48,566222,281215,285007,1724,Dresden,51.0493286,13.7381437
204.3,548186,268214,279972,2683,Hannover,52.3744779,9.7385532
186.44,526091,257320,268771,2822,Nürnberg,49.453872,11.077298
232.84,503707,249120,254587,2163,Duisburg,51.434999,6.759562
145.66,366385,178896,187489,2515,Bochum,51.4818111,7.2196635
168.39,358938,176056,182882,2132,Wuppertal,51.264018,7.1780374
258.83,338410,163288,175122,1307,Bielefeld,52.0191005,8.531007
141.06,335789,160546,175243,2380,Bonn,50.7352621,7.1024635
303.28,322904,155052,167852,1065,Münster,51.9625101,7.6251879
144.97,316877,158281,158596,2186,Mannheim,49.4892913,8.4673098
173.42,309964,158520,151444,1787,Karlsruhe,49.0068705,8.4034195
146.85,303150,149531,153619,2064,Augsburg,48.3690341,10.8979522
203.87,285522,136598,148924,1401,Wiesbaden,50.0820384,8.2416556
170.47,268943,133625,135318,1578,Mönchengladbach,51.1947131,6.4353792
104.94,265885,132249,133636,2534,Gelsenkirchen,51.5110321,7.0960124
160.85,252769,132027,120742,1571,Aachen,50.776351,6.083862
192.7,252066,124898,127168,1308,Braunschweig,52.2646577,10.5236066
221.03,250681,123838,126843,1134,Chemnitz,50.8323531,12.918914
118.65,248873,120699,128174,2098,Kiel,54.3227085,10.135555
135.56,242172,117365,124807,1786,Halle (Saale),51.4824354,11.9712985
201.68,240114,118654,121460,1191,Magdeburg,52.1315889,11.6399609
153.04,237244,112660,124584,1550,Freiburg im Breisgau,47.9960901,7.8494005
137.77,228550,111419,117131,1659,Krefeld,51.3331205,6.5623343
97.73,222889,108873,114016,2281,Mainz,49.9995205,8.2736253
214.19,219044,105259,113785,1023,Lübeck,53.866444,10.684738
269.91,215675,104791,110884,799,Erfurt,50.9777974,11.0287364
77.09,211099,103059,108040,2738,Oberhausen,51.4696137,6.8514435
181.36,210795,103349,107446,1162,Rostock,54.0886707,12.1400211
106.79,204687,100203,104484,1917,Kassel,51.3157833,9.4978479
160.45,190490,93469,97021,1187,Hagen,51.3582945,7.473296
188.24,187119,90107,97012,994,Potsdam,52.4009309,13.0591397
167.52,183509,91475,92034,1095,Saarbrücken,49.234362,6.996379
226.66,180761,89286,91475,797,Hamm,50.0165178,6.4184628
77.43,176110,88552,87558,2274,Ludwigshafen am Rhein,49.4704113,8.4381568
103.09,174629,83608,91021,1694,Oldenburg (Oldenburg),53.1389753,8.2146017
91.28,173255,83637,89618,1898,Mülheim an der Ruhr,51.4272925,6.8829192
119.8,166960,80585,86375,1394,Osnabrück,52.2719595,8.047635
78.87,166414,81121,85293,2110,Leverkusen,51.0324743,6.9881194
122.07,164792,84206,80586,1350,Darmstadt,49.8851869,8.6736295
108.83,162960,77929,85031,1497,Heidelberg,49.4093582,8.694724
89.54,161545,78754,82791,1804,Solingen,51.1721629,7.0845893
80.86,159465,78024,81441,1972,Regensburg,49.0195333,12.0974869
51.42,157896,77401,80495,3071,Herne,51.5380394,7.219985
179.59,155749,77843,77906,867,Paderborn,51.7177044,8.752653
99.52,155163,75336,79827,1559,Neuss,51.1981778,6.6916476
133.35,142308,72076,70232,1067,Ingolstadt,48.7630165,11.4250395
44.88,135490,67279,68211,3019,Offenbach am Main,50.1055002,8.7610698
63.35,132032,64793,67239,2084,Fürth,49.4885711,10.9587203
99.89,130093,65794,64299,1302,Heilbronn,49.142291,9.218655
118.68,129942,64384,65558,1095,Ulm,48.3984968,9.9912458
97.99,128992,63717,65275,1316,Pforzheim,48.890934,8.7025509
87.6,128246,61560,66686,1464,Würzburg,49.7780356,9.9434769
204.62,127256,63352,63904,622,Wolfsburg,52.4205588,10.7861682
117.02,120261,58433,61828,1028,Göttingen,51.5328328,9.9351811
100.61,118705,57841,60864,1180,Bottrop,51.521581,6.929204
87.04,118528,58803,59725,1362,Reutlingen,48.4919508,9.2114144
76.96,117806,58694,59112,1531,Erlangen,49.5891571,10.9812072
105.25,115298,56682,58616,1095,Koblenz,50.3533278,7.5943951
101.41,114677,56716,57961,1131,Bremerhaven,53.5505392,8.5851945
74.52,112970,56058,56912,1516,Remscheid,51.1798706,7.1943544
117.06,112737,55783,56954,963,Trier,49.7596208,6.6441878
83.09,112660,53929,58731,1356,Bergisch Gladbach,50.9929303,7.1277379
66.5,111693,54223,57470,1680,Recklinghausen,51.6143815,7.1978546
114.77,110791,55060,55731,965,Jena,50.9281717,11.5879359
67.64,105606,51248,54358,1561,Moers,51.451283,6.62843
224.49,105039,52386,52653,468,Salzgitter,52.1503721,10.3593147
76.28,103184,50927,52257,1353,Hanau,50.132881,8.9169797
112.02,102464,50733,51731,915,Gütersloh,51.9063997,8.3782078
92.29,102325,48866,53459,1109,Hildesheim,52.1527188,9.9518083
114.69,102114,50110,52004,890,Siegen,50.8751175,8.0256131
139.7,101486,51241,50245,726,Kaiserslautern,49.4432174,7.7689951
165.61,100010,48883,51127,604,Cottbus/Chóśebuz,51.7567447,14.3357307
130.52,98733,47339,51394,756,Schwerin,53.6288297,11.4148038
46.43,95881,48521,47360,2065,Esslingen am Neckar,48.7427584,9.3071685
72.4,95724,46540,49184,1322,Witten,51.4370171,7.335124
72.61,94996,46730,48266,1308,Gießen,50.5808795,8.6938161
43.34,94859,46775,48084,2189,Ludwigsburg,48.8953937,9.1895147
152.18,94847,45922,48925,623,Gera,50.8765537,12.0832666
108.07,93615,44250,49365,866,Tübingen,48.5203263,9.053596
85.01,93323,46221,47102,1098,Düren,50.8031684,6.4820806
56.73,92667,45905,46762,1633,Flensburg,54.7833021,9.4333264
125.49,92404,45063,47341,736,Iserlohn,51.3746778,7.6999713
165.53,89145,43827,45318,539,Villingen-Schwenningen,48.063152,8.4929618
102.58,87593,42936,44657,854,Zwickau,50.7185043,12.4939267
88.74,87513,42309,45204,986,Ratingen,51.2973261,6.8493503
59.39,87266,42512,44754,1469,Lünen,51.6142482,7.5228088
54.12,85770,40910,44860,1585,Konstanz,47.659216,9.1750718
108.73,85609,42650,42959,787,Worms,49.6302618,8.3620898
87.76,85001,41621,43380,969,Marl,51.6485843,7.0829054
101.12,83100,40938,42162,822,Minden,49.823792,6.4688309
58.1,82719,40260,42459,1424,Norderstedt,53.7089898,9.9891914
74.9,82462,40423,42039,1101,Velbert,51.3406713,7.0439912
54.62,80580,39589,40991,1475,Bamberg,49.8916044,10.8868478
71.66,80185,39772,40413,1119,Neumünster,54.0703296,9.9884451
245.78,79686,38528,41158,324,Dessau-Roßlau,51.8465924,12.2312238
91.1,79250,38609,40641,870,Viersen,51.2562118,6.3905476
62.45,78979,38984,39995,1265,Delmenhorst,53.048095,8.6286066
145.0,78220,38599,39621,539,Rheine,52.2797707,7.4373615
123.91,78203,36852,41351,631,Marburg,50.8090106,8.7704695
70.5,77511,37099,40412,1099,Lüneburg,53.248706,10.407855
171.2,76842,37356,39486,449,Dorsten,51.6604071,6.9647431
62.0,76503,37608,38895,1234,Troisdorf,50.8153071,7.1593271
107.11,76247,37481,38766,712,Wilhelmshaven,53.5278793,8.106301
35.97,75799,36883,38916,2107,Gladbeck,51.5718665,6.9877343
65.83,75272,36756,38516,1143,Landshut,48.536217,12.1516551
66.89,74907,36670,38237,1120,Bayreuth,49.9449711,11.5734327
129.39,74835,36108,38727,578,Detmold,51.936284,8.8791526
51.68,74370,36409,37961,1439,Castrop-Rauxel,51.5646195,7.3106175
193.72,74206,36458,37748,383,Arnsberg,51.4002384,8.0605908
229.73,73921,36286,37635,322,Brandenburg an der Havel,52.4108261,12.5497933
62.45,72918,35432,37486,1168,Aschaffenburg,49.9706701,9.1384857
119.4,72409,35603,36806,606,Bocholt,51.8382715,6.6148669
87.02,71463,35125,36338,821,Lüdenscheid,51.218137,7.6396975
63.28,70713,35028,35685,1117,Kempten (Allgäu),47.7267063,10.3168835
104.05,70366,34810,35556,676,Fulda,50.5542328,9.6770448
176.02,70293,34005,36288,399,Celle,52.624056,10.081052
146.58,69147,34458,34689,472,Aalen,48.8375607,10.0929593
113.68,69047,34046,35001,607,Lippstadt,51.6747074,8.347194
47.66,67949,32750,35199,1426,Dinslaken,51.5623618,6.7345106
58.29,67656,33895,33761,1161,Rüsselsheim am Main,49.9819502,8.446357
113.96,67627,33332,34295,593,Kerpen,50.3008642,6.7397609
79.15,67265,33011,34254,850,Herford,52.1152245,8.6711118
86.5,66243,32664,33579,766,Neuwied,50.4302393,7.466302
84.47,65611,31599,34012,777,Weimar,50.9793301,11.3297921
50.83,65504,32668,32836,1289,Sindelfingen,48.7084162,9.0035455
102.11,65218,31970,33248,639,Plauen,50.4950632,12.1346523
37.22,65192,32453,32739,1752,Rosenheim,47.8539273,12.127262
85.5,65170,32435,32735,762,Dormagen,51.0934389,6.8416158
102.52,64588,31179,33409,630,Grevenbroich,51.0905783,6.5835365
86.12,64390,31154,33236,748,Neubrandenburg,53.5574458,13.2602781
69.93,63441,31422,32019,907,Friedrichshafen,47.6500279,9.4800858
113.81,62726,30575,32151,551,Schwäbisch Gmünd,48.7999036,9.7977584
37.33,62204,30351,31853,1666,Herten,51.5942009,7.1368071
78.37,62195,30807,31388,794,Offenburg,48.4695984,7.9429235
96.34,62172,30305,31867,645,Bergheim,50.9540457,6.6410004
80.95,61780,30663,31117,763,Neu-Ulm,48.3953489,10.0005211
79.49,61594,30032,31562,775,Garbsen,52.4276606,9.6005102
122.56,61277,29776,31501,500,Wesel,51.6576909,6.617087
51.22,61252,29876,31376,1196,Hürth,50.8807379,6.876568
139.49,60256,29737,30519,432,Euskirchen,50.6612623,6.7871219
88.56,60223,29278,30945,680,Unna,51.5348835,7.689014
50.81,60071,28501,31570,1182,Greifswald,54.095791,13.3815238
41.15,59908,29103,30805,1456,Langenfeld (Rheinland),51.1008952,6.9459377
54.59,59450,28865,30585,1089,Stralsund,54.3096314,13.0820846
59.21,59300,29501,29799,1002,Göppingen,48.7031377,9.6541116
147.85,58818,28657,30161,398,Frankfurt (Oder),52.3412273,14.549452
102.53,57916,27702,30214,565,Hameln,52.1039941,9.3561569
64.4,57440,27562,29878,892,Meerbusch,51.2652237,6.6760958
140.19,57420,27501,29919,410,Baden-Baden,48.7610716,8.239959
176.19,57075,28507,28568,324,Lingen (Ems),52.5224659,7.316584
67.53,56694,27284,29410,840,Görlitz,51.1563185,14.991018
34.22,56692,27764,28928,1657,Sankt Augustin,50.7752776,7.1895507
98.48,56584,27954,28630,575,Stolberg (Rhld.),50.7702908,6.2295504
72.15,56284,27201,29083,780,Pulheim,50.9979888,6.8025409
75.75,56132,27589,28543,741,Eschweiler,50.8175029,6.2630894
51.14,55995,26558,29437,1095,Bad Homburg v. d. Höhe,50.2363508,8.5980265
42.75,55917,27369,28548,1308,Waiblingen,48.8325659,9.3163822
71.97,55746,27551,28195,775,Langenhagen,52.443118,9.738994
25.95,55689,26861,28828,2146,Hilden,51.1674417,6.9307271
149.86,55619,27426,28193,371,Nordhorn,52.4359731,7.0707659
35.7,55067,27308,27759,1542,Schweinfurt,50.0518552,10.2220921
75.65,54629,26517,28112,722,Wetzlar,50.570561,8.531245
71.67,54620,26519,28101,762,Hattingen,51.4007175,7.1862486
100.05,54585,26388,28197,546,Bad Salzuflen,52.0771518,8.7554739
69.56,54401,26467,27934,782,Passau,48.5748229,13.4609744
117.09,53920,26353,27567,461,Neustadt an der Weinstraße,49.3539802,8.1350021
97.76,53458,26550,26908,547,Kleve,51.7895571,6.1376008
123.13,53278,26030,27248,433,Ahlen,51.7627633,7.8909086
45.06,53128,25954,27174,1179,Frechen,50.9096219,6.8081935
78.74,53034,26166,26868,674,Wolfenbüttel,52.1625283,10.5348215
55.56,52989,25315,27674,954,Bad Kreuznach,49.8490413,7.8626661
108.87,52688,26068,26620,484,Ibbenbüren,52.2774772,7.7151417
86.1,52177,25478,26699,606,Menden (Sauerland),51.43779,7.7953822
39.04,52093,25834,26259,1334,Böblingen,48.684969,9.0113444
95.41,51845,25564,26281,543,Gummersbach,51.0277658,7.5630545
58.98,51800,25947,25853,878,Rastatt,48.8574209,8.2088088
92.05,51788,25920,25868,563,Ravensburg,47.7811014,9.612468
119.84,51521,25482,26039,430,Peine,52.3117289,10.251904
42.71,51203,24998,26205,1199,Speyer,49.3165553,8.433615
21.36,50728,24907,25821,2375,Elmshorn,53.7532486,9.6524559
39.37,50670,24746,25924,1287,Lörrach,47.6120896,7.6607218
112.34,50659,25242,25417,451,Emden,53.3670541,7.2058304
163.88,50253,24592,25661,307,Goslar,51.9059936,10.4266284
67.8,50212,24605,25607,741,Willich,51.2641433,6.5446958
78.82,50151,25126,25025,636,Gronau (Westf.),52.2085731,7.0264443
119.89,50018,24230,25788,417,Erftstadt,50.8027168,6.8031625
88.59,49939,25165,24774,564,Freising,48.4008273,11.7439565
107.09,49895,24928,24967,466,Heidenheim an der Brenz,48.6767637,10.152923
86.72,49849,24930,24919,575,Rheda-Wiedenbrück,51.8428202,8.2985615
48.73,49845,24864,24981,1023,Leonberg,48.8012983,9.0150026
67.59,49775,25214,24561,736,Straubing,48.8839157,12.5955773
64.83,49566,24345,25221,765,Bad Oeynhausen,52.2014399,8.7981244
61.77,49518,24134,25384,802,Singen (Hohentwiel),47.7617515,8.8348709
44.9,49475,24606,24869,1102,Bergkamen,51.6149389,7.6362876
69.84,49420,24807,24613,708,Lahr/Schwarzwald,48.338896,7.8710825
43.88,49122,24061,25061,1119,Frankenthal (Pfalz),49.5353466,8.3541391
82.69,49074,23918,25156,593,Bornheim,50.7627913,6.9890508
161.93,48713,23119,25594,301,Cuxhaven,53.86878,8.698286
110.07,48708,23767,24941,443,Stade,53.599794,9.475438
31.68,48518,24062,24456,1532,Alsdorf,49.8885782,6.4643156
163.69,48492,23665,24827,296,Oranienburg,52.7529379,13.2457591
82.94,48341,23072,25269,583,Landau in der Pfalz,49.1982825,8.1123441
34.96,48337,23675,24662,1383,Dachau,48.2592477,11.4354419
85.81,48250,23492,24758,562,Soest,51.5725501,8.1061259
105.89,48190,23403,24787,455,Hennef (Sieg),50.7754417,7.2847945
184.83,47937,23457,24480,259,Dülmen,51.8283677,7.2791406
253.95,47387,23564,23823,187,Melle,52.200762,8.338667
45.34,47241,22908,24333,1042,Oberursel (Taunus),50.2062948,8.5461079
75.26,47097,23178,23919,626,Neunkirchen,50.5456179,8.1025344
33.38,47071,22827,24244,1410,Herzogenrath,50.8684545,6.0950514
93.04,47014,23693,23321,505,Bruchsal,49.124118,8.5980244
58.02,46963,22880,24083,809,Hof,50.3219015,11.9178807
134.4,46831,23278,23553,348,Albstadt,48.233048,8.9991483
65.04,46683,23229,23454,718,Rodgau,50.0176771,8.8853392
56.23,46571,22928,23643,828,Schwerte,51.445525,7.5674652
40.02,46386,22925,23461,1159,Kaufbeuren,47.8803788,10.622246
69.58,46300,22783,23517,665,Gotha,50.9494849,10.7014435
38.55,46295,22972,23323,1201,Filderstadt,48.6664,9.2199647
27.71,46205,22498,23707,1667,Fellbach,48.8181556,9.278085
70.11,46178,22848,23330,659,Memmingen,47.9863099,10.1808016
59.3,45891,22333,23558,774,Bünde,52.2004727,8.5828944
241.77,45588,22091,23497,189,Wittenberg,51.8666527,12.646761
36.12,45515,21670,23845,1260,Brühl,50.8291313,6.9037057
58.11,45381,22073,23308,781,Weinheim,49.5462349,8.6717458
358.96,45325,22450,22875,126,Neustadt am Rübenberge,52.5055135,9.4635826
127.67,45097,22516,22581,353,Lehrte,52.3749334,9.9748557
43.34,45005,22083,22922,1038,Falkensee,52.5606426,13.08824
142.27,44791,22173,22618,315,Rottenburg am Neckar,48.47696,8.9336788
21.54,44756,21967,22789,2078,Pinneberg,53.7278939,9.6979598
117.34,44572,21836,22736,380,Erkelenz,51.080992,6.3160684
104.19,44254,21422,22832,425,Bernau bei Berlin,52.6787254,13.5881114
37.39,44208,21153,23055,1182,Kaarst,51.226675,6.6193924
41.73,44022,21256,22766,1055,Wismar,53.8909832,11.4647932
105.39,43941,21621,22320,417,Gifhorn,52.5780612,10.6613448
31.29,43808,21524,22284,1400,Bietigheim-Bissingen,48.9493243,9.1364229
26.88,43801,20976,22825,1630,Erkrath,51.2209866,6.9056079
92.21,43620,21576,22044,473,Heinsberg,51.0654268,6.0984461
153.24,43589,21513,22076,284,Borken,51.8444777,6.8583277
23.05,43524,20992,22532,1888,Monheim am Rhein,51.0909476,6.8812387
83.87,43425,21396,22029,518,Nettetal,51.3155092,6.2714171
197.29,43375,21461,21914,220,Aurich,53.5122853,7.3915284
70.57,43188,20955,22233,612,Weiden i.d.OPf.,49.6752749,12.1631636
40.95,43001,21060,21941,1050,Kamen,51.5918019,7.6616804
104.17,42817,21168,21649,411,Eisenach,50.9747134,10.3193565
104.19,42743,20927,21816,410,Schwäbisch Hall,49.1123963,9.7369047
50.14,42676,21100,21576,851,Amberg,49.4543662,11.8474021
34.16,42560,20432,22128,1246,Laatzen,52.3077423,9.8132829
82.61,42498,20751,21747,514,Homburg,49.3181673,7.3340336
53.27,42389,20916,21473,796,Dreieich,50.011974,8.7123912
99.91,42311,20297,22014,423,Ansbach,49.2888745,10.5597693
40.47,42178,20854,21324,1042,Kirchheim unter Teck,48.6480545,9.4510227
48.29,42139,20616,21523,873,Coburg,50.2582226,10.964561
23.66,42025,20669,21356,1776,Siegburg,50.7928332,7.2070774
21.61,41822,20347,21475,1935,Germering,48.1373576,11.3614338
57.83,41758,20526,21232,722,Bensheim,49.6977,8.6288
93.63,41704,20357,21347,445,Eberswalde,52.8350807,13.7996542
125.74,41666,20278,21388,331,Wunstorf,52.4257979,9.4294425
76.2,41642,20249,21393,546,Königswinter,50.6739719,7.1930989
61.27,41594,20544,21050,679,Hückelhoven,51.0552368,6.2247322
46.88,41447,20658,20789,884,Nürtingen,48.6265854,9.3365463
40.8,41380,20296,21084,1014,Schwabach,49.3290521,11.0207677
74.76,41290,19880,21410,552,Buchholz in der Nordheide,53.3333021,9.8666653
76.69,41256,20413,20843,538,Buxtehude,53.4767351,9.7003941
79.01,41255,20356,20899,522,Neumarkt i.d.OPf.,49.279624,11.4594662
108.24,41233,20327,20906,381,Nordhausen,51.5051574,10.7925317
48.31,41045,20683,20362,850,Freiberg,50.9169415,13.3428889
61.35,40941,20076,20865,667,Pirmasens,49.1996961,7.6087847
56.83,40614,20060,20554,715,Schorndorf,48.8055169,9.5272665
151.24,40580,20313,20267,268,Ahaus,52.0761541,7.004876
100.85,40531,20014,20517,402,Lemgo,52.0280674,8.9012894
29.89,40526,20024,20502,1356,Leinfelden-Echterdingen,48.6901796,9.1525725
57.43,40412,19733,20679,704,Hofheim am Taunus,50.09494,8.42285
67.1,40358,19729,20629,601,Völklingen,49.2522866,6.859519
59.51,40162,19711,20451,675,Löhne,52.1965102,8.7139521
143.27,40069,20226,19843,280,Halberstadt,51.8953514,11.0520563
29.12,40009,19714,20295,1374,Langen (Hessen),49.9927036,8.6671682
22.81,39833,19708,20125,1746,Ostfildern,48.7178603,9.2630693
56.75,39763,19326,20437,701,Ettlingen,48.9414188,8.4076347
32.41,39698,19586,20112,1225,Maintal,50.1438711,8.8371266
40.46,39477,19229,20248,976,Freital,51.016265,13.6530329
35.79,39424,19464,19960,1102,Niederkassel,50.8137102,7.0351942
24.29,39420,19349,20071,1623,Neu-Isenburg,50.0464196,8.6717748
53.06,39303,19050,20253,741,Pirna,50.9616923,13.9386643
42.56,39197,18844,20353,921,Mettmann,51.2527778,6.9777778
113.96,39181,19310,19871,344,Weißenfels,51.1999793,11.9667857
198.69,39147,20192,18955,197,Ilmenau,50.6867695,10.9142385
96.04,39096,19205,19891,407,Königs Wusterhausen,52.2994511,13.6244389
269.24,38946,18880,20066,145,Stendal,52.6050782,11.8594279
118.44,38841,19746,19095,328,Papenburg,53.0822606,7.3928398
34.39,38750,18926,19824,1127,Würselen,50.8178682,6.1341108
63.14,38731,19009,19722,613,Kamp-Lintfort,51.5017981,6.547923
75.07,38721,19258,19463,516,Kehl,48.5728929,7.8109768
23.37,38355,18979,19376,1641,Wesseling,50.8247166,6.9810852
140.26,38321,18837,19484,273,Greven,52.0929254,7.6120326
32.52,38187,18645,19542,1174,Fürstenfeldbruck,48.1794705,11.2547202
39.38,38184,19104,19080,970,Backnang,48.9470756,9.4297925
66.67,38039,18518,19521,571,Bautzen / Budyšin,51.1813907,14.4275735
159.03,38033,18427,19606,239,Haltern am See,51.7430516,7.187221
87.23,37850,18473,19377,434,Bitterfeld-Wolfen,51.6425032,12.3076334
176.88,37847,18471,19376,214,Warendorf,51.9532449,7.9912335
90.45,37784,19008,18776,418,Tuttlingen,47.9844315,8.8186606
111.46,37452,18560,18892,336,Beckum,51.7555148,8.041135
70.86,37280,18436,18844,526,Cloppenburg,52.8461339,8.0438783
141.36,37259,18415,18844,264,Coesfeld,51.9458943,7.1691108
54.61,37169,17972,19197,681,Erding,48.3064441,11.9076579
141.62,36986,18488,18498,261,Suhl,50.6086518,10.6926437
126.99,36978,18345,18633,291,Sinsheim,49.2553,8.87722
135.52,36641,17804,18837,270,Mühlhausen/Thüringen,51.2094255,10.4589044
72.06,36556,18115,18441,507,Emsdetten,52.174687,7.5301756
45.16,36506,18055,18451,808,Limburg a. d. Lahn,50.406558,8.075668
109.77,36499,17951,18548,333,Winsen (Luhe),53.3636474,10.2059206
73.31,36390,17873,18517,496,Ingelheim am Rhein,49.9752749,8.0547274
105.22,36300,18155,18145,345,Porta Westfalica,52.2394431,8.924762
53.49,36282,17829,18453,678,Voerde (Niederrhein),51.5975224,6.6811994
109.08,36239,18418,17821,332,Crailsheim,49.1365626,10.0720195
188.4,36137,18015,18122,192,Meppen,52.6947452,7.2909824
25.68,36021,17621,18400,1403,Bad Vilbel,50.19339,8.74918
77.14,35757,18294,17463,464,Deggendorf,48.7814115,13.0006423
115.43,35520,17790,17730,308,Goch,51.6755765,6.1593045
111.67,35456,17670,17786,318,Steinfurt,52.138683,7.3678356
44.13,35359,17947,17412,801,Mörfelden-Walldorf,49.9923836,8.5622468
76.04,35311,17337,17974,464,Lage,51.9914084,8.7919583
21.68,35268,17532,17736,1627,Dietzenbach,50.0171926,8.784277
66.1,35200,17227,17973,533,Datteln,51.651468,7.3385906
70.11,35163,17110,18053,502,Leer (Ostfriesland),53.2332168,7.4567555
49.95,35059,16895,18164,702,St. Ingbert,49.2788378,7.1156707
90.32,35054,17120,17934,388,Balingen,48.2737512,8.8557862
102.81,34955,17261,17694,340,Barsinghausen,52.30223,9.4623741
43.3,34893,16856,18037,806,Saarlouis,49.3164661,6.749846
68.8,34888,16898,17990,507,Kempen,51.3642126,6.4195011
54.08,34798,17220,17578,643,Seelze,52.3964639,9.594287
53.87,34721,17053,17668,645,Merseburg,51.3564413,11.996148
74.8,34673,16870,17803,464,Wermelskirchen,51.1406481,7.2156901
33.81,34617,16757,17860,1024,Wedel,53.5810226,9.7038772
70.64,34613,17203,17410,490,Zweibrücken,49.248655,7.3641981
96.97,34604,17334,17270,357,Geldern,51.5169736,6.3228189
35.29,34601,16433,18168,980,Ahrensburg,53.6736529,10.2358999
48.41,34348,16846,17502,710,Viernheim,49.5401213,8.5785313
72.15,34331,16906,17425,476,Biberach an der Riß,48.0984413,9.7899938
55.24,34324,16688,17636,621,Korschenbroich,51.1902651,6.5143539
14.65,34177,16825,17352,2333,Kornwestheim,48.8611498,9.1873875
87.89,34145,17010,17135,388,Vechta,52.7310691,8.2873162
136.84,33991,16472,17519,248,Uelzen,52.9840679,10.5385882
67.66,33916,16816,17100,501,Hemer,51.3854116,7.7661798
62.84,33849,16704,17145,539,Rheinfelden (Baden),47.5605924,7.7861959
32.54,33809,16042,17767,1039,Bad Nauheim,50.3681107,8.7473608
26.14,33804,16322,17482,1293,Radebeul,51.0999765,13.6767995
360.74,33635,16248,17387,93,Schwedt/Oder,53.0586366,14.2840858
44.44,33610,16410,17200,756,Forchheim,49.7187319,11.0595749
90.39,33359,16767,16592,369,Jülich,50.9220931,6.3611015
72.27,33053,16433,16620,457,Lampertheim,49.6239449,8.4093474
65.7,32961,16173,16788,502,Herrenberg,48.5963819,8.8702368
68.06,32961,16040,16921,484,Achim,53.0120987,9.0360486
157.28,32874,16706,16168,209,Delbrück,51.7649178,8.5594953
70.67,32763,16242,16521,464,Fürstenwalde/Spree,52.3580209,14.064985
33.25,32763,16212,16551,985,Geesthacht,53.4374683,10.3678235
58.55,32575,15679,16896,556,Radolfzell am Bodensee,47.7372802,8.9702755
64.53,32423,15689,16734,502,Nienburg (Weser),52.6487602,9.2578105
130.25,32336,15683,16653,248,Naumburg (Saale),51.1525648,11.8099186
28.54,32319,15545,16774,1132,Itzehoe,53.919448,9.5172441
80.4,32157,16149,16008,400,Emmerich am Rhein,51.8322137,6.2428283
113.92,32106,15530,16576,282,Bernburg (Saale),51.7930788,11.7391606
55.49,32022,15696,16326,577,Georgsmarienhütte,52.2,8.05
170.5,31943,15289,16654,187,Wernigerode,51.8344172,10.7862526
38.66,31918,15585,16333,826,Oer-Erkenschwick,51.6398512,7.2605914
305.19,31803,15578,16225,104,Neuruppin,52.9243859,12.8092919
183.39,31801,16243,15558,173,Bramsche,52.4075184,7.9791742
356.56,31713,15402,16311,89,Geestland,53.6096722,8.5943804
45.69,31580,15140,16440,691,Altenburg,50.9852411,12.4340988
94.99,31404,15158,16246,331,Hoyerswerda / Wojerecy,51.4333103,14.250083
112.56,31302,15247,16055,278,Burgdorf,52.4438008,10.0078364
71.07,31251,15409,15842,440,Kreuztal,50.9598627,7.9896202
26.34,31198,15198,16000,1184,Gevelsberg,51.3207417,7.3404792
50.18,31131,15745,15386,620,Friedberg (Hessen),50.3352682,8.7539306
75.24,31096,15222,15874,413,Rheinberg,51.5458979,6.6014097
19.46,31065,15131,15934,1596,Weil am Rhein,47.5932802,7.6116133
76.35,30938,15802,15136,405,Werl,51.5533457,7.9155558
65.62,30894,15085,15809,471,Lohmar,50.8402243,7.2127276
336.46,30890,15251,15639,92,Walsrode,52.8625395,9.5883023
81.29,30881,15525,15356,380,Neuburg a.d.Donau,48.7371951,11.1795268
67.02,30820,14900,15920,460,Taunusstein,50.1390989,8.1503316
73.87,30770,15098,15672,417,Bad Hersfeld,50.8604177,9.6767709
231.92,30725,15021,15704,132,Einbeck,51.8185067,9.8678465
147.17,30717,14960,15757,209,Osterholz-Scharmbeck,53.2281763,8.7948239
81.25,30670,15049,15621,377,Friedberg,48.3551962,10.9786498
24.19,30558,14627,15931,1263,Haan,51.1954956,7.0085328
23.75,30545,15548,14997,1286,Rendsburg,54.3000225,9.6516356
57.77,30502,14836,15666,528,Ennepetal,51.2967192,7.3693335
110.31,30461,15375,15086,276,Rietberg,51.8074106,8.4286614
53.34,30408,14811,15597,570,Andernach,50.4391924,7.4023145
86.52,30402,14819,15583,351,Schönebeck (Elbe),52.0205998,11.7383277
123.8,30239,15101,15138,244,Schwandorf,49.3261854,12.1092708
65.01,30190,14902,15288,464,Gaggenau,48.8030291,8.3201799
71.1,30136,14994,15142,424,Bretten,49.0366265,8.7068077
108.98,30070,15051,15019,276,Merzig,49.4427023,6.6374902
218.52,29988,14953,15035,137,Meschede,51.3436532,8.2859257
76.14,29868,14413,15455,392,Werne,51.66268,7.6355052
102.77,29783,14874,14909,290,Oelde,51.8260823,8.1453352
57.9,29739,14842,14897,514,Landsberg am Lech,48.0497474,10.8768728
14.93,29661,14991,14670,1987,Unterschleißheim,48.2730686,11.5702716
47.09,29586,14282,15304,628,Waltrop,51.6237456,7.400959
71.09,29582,14341,15241,416,Güstrow,53.793587,12.1764906
20.67,29452,14709,14743,1425,Mühlheim am Main,50.1080582,8.8467138
109.99,29441,14564,14877,268,Ludwigsfelde,52.3016096,13.2610163
28.05,29436,14494,14942,1049,Winnenden,48.8754571,9.3978478
73.4,29387,14608,14779,400,Vaihingen an der Enz,48.9321398,8.9568316
145.85,29337,14326,15011,201,Northeim,51.7643823,9.8583289
44.34,29331,14479,14852,662,Tönisvorst,51.3167,6.45
75.83,29261,14813,14448,386,Geislingen an der Steige,48.6218033,9.8372796
160.13,29258,14202,15056,183,Springe,52.2099318,9.5581577
73.18,29214,14348,14866,399,Bühl,48.6945066,8.134423
38.8,29206,14279,14927,753,Rösrath,50.8963758,7.1825445
91.58,29158,14264,14894,318,Idar-Oberstein,49.7107134,7.3136563
58.91,29127,14011,15116,494,Riesa,51.3038241,13.308828
145.56,29121,14174,14947,200,Saalfeld/Saale,50.6479143,11.3610041
30.73,29106,14224,14882,947,Kelkheim (Taunus),50.1344038,8.4531845
30.92,29051,13924,15127,940,Meißen,51.1630871,13.4704939
33.78,29035,14071,14964,860,Emmendingen,48.1206565,7.850993
136.48,28900,14371,14529,212,Mechernich,50.5909999,6.6525479
29.99,28835,14082,14753,961,Rödermark,49.9798913,8.8088274
158.16,28749,14231,14518,182,Höxter,51.7938902,9.348855
15.8,28720,14326,14394,1818,Hattersheim am Main,50.056,8.4819
20.5,28711,13832,14879,1401,Schwelm,51.2841166,7.2924712
31.27,28579,14061,14518,914,Reinbek,53.5098898,10.2511001
100.64,28466,14076,14390,283,Kevelaer,51.5802996,6.2456273
71.7,28453,13777,14676,397,Verden (Aller),52.9410675,9.2354716
83.16,28399,14233,14166,341,Geilenkirchen,50.963605,6.1199802
18.48,28377,13963,14414,1536,Königsbrunn,48.2679546,10.8883816
87.74,28345,13706,14639,323,Zeitz,51.0491637,12.1349991
38.27,28298,13614,14684,739,Baunatal,51.2550775,9.4119007
218.23,28269,13895,14374,130,Grimma,51.2383379,12.7287511
104.99,28264,14262,14002,269,Arnstadt,50.8349097,10.9461479
21.55,28210,14085,14125,1309,Griesheim,49.8615899,8.5762043
37.26,28202,13527,14675,757,Leichlingen (Rheinland),51.1087572,7.0115768
43.5,28110,13583,14527,646,Neukirchen-Vluyn,51.4413742,6.5467641
29.92,28052,13687,14365,938,Olching,48.2077801,11.3278779
27.84,28005,13563,14442,1006,Baesweiler,50.9074568,6.1826282
91.11,27949,14053,13896,307,Lohne (Oldenburg),52.665257,8.2363523
21.59,27880,13740,14140,1291,Teltow,52.3805562,13.2685278
193.27,27783,13918,13865,144,Sundern (Sauerland),51.329832,8.0072645
67.94,27780,13383,14397,409,Strausberg,52.5588942,13.9042481
63.38,27647,13317,14330,436,Bad Neuenahr-Ahrweiler,50.5444551,7.1186671
52.12,27610,13758,13852,530,Heppenheim (Bergstraße),49.64999,8.66768
101.35,27608,13454,14154,272,Wangen im Allgäu,47.6856552,9.8342247
106.6,27528,13904,13624,258,Butzbach,50.4261402,8.6539728
67.52,27520,13592,13928,408,Schloß Holte-Stukenbrock,51.9017108,8.6353438
178.33,27504,13895,13609,154,Ehingen (Donau),48.2828519,9.7262175
68.88,27489,13409,14080,399,Overath,50.9320015,7.2839042
31.55,27450,13567,13883,870,Wetter (Ruhr),51.3879463,7.3951553
164.53,27450,13691,13759,167,Hamminkeln,51.7306922,6.590865
84.34,27305,13210,14095,324,Wegberg,51.1423588,6.2776865
20.64,27286,13458,13828,1322,Leimen,49.3491417,8.6909951
31.71,27245,13399,13846,859,Weinstadt,48.8085568,9.3774813
69.72,27238,13693,13545,391,Rheinbach,50.6256808,6.9491436
92.63,27143,13431,13712,293,Pfaffenhofen a.d.Ilm,48.5296743,11.5084954
48.56,27131,13242,13889,559,Hohen Neuendorf,52.6732755,13.2807255
30.24,27120,13496,13624,897,Wiesloch,49.2942599,8.698707
117.12,26970,13228,13742,230,Werder (Havel),52.3715809,12.9329125
60.41,26767,13299,13468,443,Selm,51.7005549,7.468614
65.24,26664,13262,13402,409,Achern,48.6300161,8.0735581
54.32,26664,13302,13362,491,Mühlacker,48.9487272,8.8492931
31.48,26623,13004,13619,846,Hennigsdorf,52.6375777,13.2057511
54.47,26614,13264,13350,489,Groß-Gerau,49.914,8.4657
27.52,26590,12934,13656,966,Heiligenhaus,51.32658,6.9710401
22.82,26589,13270,13319,1165,Remseck am Neckar,48.8727053,9.2735947
24.94,26523,13195,13328,1063,Neckarsulm,49.191133,9.2248391
156.83,26416,12722,13694,168,Aschersleben,51.7559549,11.462134
59.86,26413,12944,13469,441,Lauf a.d.Pegnitz,49.5118126,11.2813381
87.77,26410,13210,13200,301,Nordenham,53.4973636,8.4820227
37.68,26339,13024,13315,699,Bingen am Rhein,49.9675456,7.8944
34.4,26291,13396,12895,764,Weiterstadt,49.9178,8.5924
28.79,26257,12766,13491,912,Zirndorf,49.445762,10.9560462
65.04,26161,12819,13342,402,Lübbecke,52.3027209,8.6183054
33.06,26155,12633,13522,791,Lindau (Bodensee),47.550753,9.6926624
100.59,26126,13156,12970,260,Harsewinkel,51.9617153,8.2252425
92.77,26052,12654,13398,281,Kulmbach,50.1008448,11.4479149
48.14,26025,12499,13526,541,Bad Honnef,50.6448582,7.2272534
30.13,25937,12728,13209,861,Friedrichsdorf,50.2620906,8.6248898
24.3,25904,12622,13282,1066,Schleswig,54.51851,9.5653284
24.6,25863,12857,13006,1051,Geretsried,47.8646925,11.479351
79.76,25709,12326,13383,322,Idstein,50.2212764,8.269554
119.76,25695,13004,12691,215,Horb am Neckar,48.4447943,8.6914794
71.37,25691,12954,12737,360,Verl,51.8830037,8.5093149
66.74,25633,12510,13123,384,Helmstedt,52.2089226,11.0028882
109.02,25626,12544,13082,235,Rinteln,52.1873798,9.0804584
229.16,25624,12749,12875,112,Brilon,51.3955721,8.5677743
67.79,25591,12682,12909,378,Öhringen,49.2005034,9.5024397
71.76,25548,12642,12906,356,Rottweil,48.1678244,8.626979
13.62,25531,12570,12961,1875,Obertshausen,50.0731304,8.8732839
12.16,25521,12386,13135,2099,Weingarten,47.8075299,9.6431145
113.54,25503,12487,13016,225,St. Wendel,49.466972,7.1653135
96.33,25405,12374,13031,264,Roth,49.1952934,11.0566523
127.38,25372,12892,12480,199,Ellwangen (Jagst),48.9615975,10.131975
53.26,25356,12357,12999,476,Wiehl,50.9478489,7.5530059
85.92,25341,12489,12852,295,Delitzsch,51.5255661,12.342857
30.38,25318,12564,12754,833,Ditzingen,48.8263983,9.0658446
45.68,25311,12534,12777,554,Stutensee,49.0895249,8.4856806
140.54,25306,12572,12734,180,Lüdinghausen,51.7717757,7.444639
208.46,25300,12257,13043,121,Sangerhausen,51.4729797,11.2981851
42.54,25299,12522,12777,595,Pfungstadt,49.7943,8.5877
84.21,25294,12336,12958,300,Espelkamp,52.3778041,8.6157377
109.8,25283,12536,12747,230,Salzkotten,51.6717596,8.6068636
135.59,25275,12650,12625,186,Lennestadt,51.1245718,8.0568953
211.94,25226,12625,12601,119,Petershagen,52.3756616,8.9668368
106.33,25210,12342,12868,237,Norden,53.5942039,7.2067435
77.96,25114,12405,12709,322,Waldshut-Tiengen,47.6281754,8.2408579
52.59,25104,12275,12829,477,Bad Oldesloe,53.8096562,10.3733692
34.84,25031,12125,12906,718,Meckenheim,50.6256627,7.0215612
77.85,24974,12102,12872,321,Köthen (Anhalt),51.751033,11.973698
303.1,24970,12604,12366,82,Schmallenberg,51.1525937,8.2836014
85.88,24961,12375,12586,291,Olpe,51.029482,7.8435278
47.94,24956,12094,12862,521,Sprockhövel,51.3666572,7.2485905
128.11,24956,12269,12687,195,Syke,52.9131332,8.8198737
113.1,24918,12106,12812,220,Rathenow,52.6063703,12.3382259
105.64,24867,12273,12594,235,Meiningen,50.56761,10.4153029
96.75,24788,12353,12435,256,Plettenberg,51.2136798,7.8745627
135.17,24767,12047,12720,183,Rudolstadt,50.7206063,11.3401985
129.96,24752,12156,12596,190,Bad Mergentheim,49.490532,9.7730692
208.79,24719,12493,12226,118,Haren (Ems),52.7905619,7.2400267
66.75,24710,12238,12472,370,Zittau,50.8960964,14.8064807
47.62,24674,12302,12372,518,Herzogenaurach,49.5710376,10.8815262
80.42,24645,12171,12474,306,Bedburg,50.9972161,6.5767648
21.56,24604,12241,12363,1141,Waldkraiburg,48.2061851,12.4021839
37.82,24505,12125,12380,648,Ronnenberg,52.3166623,9.6532075
31.47,24488,11697,12791,778,Markkleeberg,51.2785751,12.3718819
73.73,24464,12335,12129,332,Riedstadt,49.8425212,8.4829447
158.05,24464,12229,12235,155,Warstein,51.4458105,8.3536824
97.92,24452,12254,12198,250,Attendorn,51.1250541,7.9010992
59.88,24448,12360,12088,408,Calw,48.7142691,8.7397624
63.47,24447,11974,12473,385,Eisenhüttenstadt,52.1448863,14.6294413
26.09,24354,12236,12118,933,Übach-Palenberg,50.9213799,6.1128698
87.54,24337,11892,12445,278,Freudenstadt,48.4637727,8.4111727
113.75,24335,11834,12501,214,Varel,53.395777,8.1372149
103.58,24167,12148,12019,233,Sehnde,52.3144002,9.9647193
71.77,24141,11899,12242,336,Jüchen,51.1017138,6.5036893
124.11,24089,11782,12307,194,Korbach,51.2559045,8.8426963
179.55,23984,11691,12293,134,Westerstede,53.2575197,7.9273367
147.18,23963,11635,12328,163,Staßfurt,51.8514515,11.5929455
61.85,23940,11255,12685,387,Starnberg,47.9986851,11.3410791
50.21,23923,11762,12161,476,Limbach-Oberfrohna,50.8608138,12.7545462
45.15,23841,11605,12236,528,Gelnhausen,50.2043672,9.1997516
25.8,23814,11391,12423,923,Husum,54.4854137,9.0537941
91.75,23728,11700,12028,259,Döbeln,51.1167001,13.1166999
62.16,23647,11875,11772,380,Mosbach,49.3521085,9.1460205
174.97,23588,11868,11720,135,Leutkirch im Allgäu,47.8266137,10.0228027
83.76,23533,11705,11828,281,Dillenburg,50.75211,8.31573
34.01,23492,11664,11828,691,Gersthofen,48.4248151,10.8778564
23.11,23478,11420,12058,1016,Kaltenkirchen,53.8371714,9.9614889
84.69,23435,11398,12037,277,Sonneberg,50.3575412,11.1691714
137.39,23430,11635,11795,171,Netphen,50.9125904,8.1026183
121.17,23418,11516,11902,193,Hann. Münden,51.4161908,9.6550096
306.15,23394,11626,11768,76,Salzwedel,52.8528456,11.1539699
55.5,23378,11323,12055,421,Weilheim i.OB,47.8427947,11.1520087
46.99,23377,11594,11783,497,Kitzingen,49.7380667,10.1601218
168.84,23336,11453,11883,138,Warburg,51.4886533,9.1488385
63.1,23321,11588,11733,370,Nagold,48.5512399,8.7234942
138.59,23319,11630,11689,168,Wertheim,49.7599825,9.5166598
127.56,23282,11184,12098,183,Senftenberg/Zły Komorow,51.5191742,14.0046541
120.79,23277,11042,12235,193,Quedlinburg,51.7855428,11.1519933
135.83,23265,11880,11385,171,Vreden,52.035862,6.8236481
43.94,23253,11583,11670,529,Karben,50.2313417,8.7717673
25.22,23251,11159,12092,922,Neusäß,48.3928722,10.8354535
69.92,23245,10882,12363,332,Bad Kissingen,50.1985698,10.0746833
58.64,23240,10883,12357,396,Überlingen,47.7664456,9.1605106
247.5,23234,11630,11604,94,Friesoythe,53.0206088,7.8592307
12.5,23174,11135,12039,1854,Bad Soden am Taunus,50.1517006,8.4899671
25.21,23143,11290,11853,918,Senden,48.3251884,10.0471189
152.02,23133,11320,11813,152,Bad Salzungen,50.812318,10.2320784
90.79,23067,11481,11586,254,Lengerich,52.1887731,7.8508691
61.79,23044,11570,11474,373,Laupheim,48.230514,9.8771587
60.27,22924,11124,11800,380,Stadthagen,52.3289688,9.2053496
46.26,22896,11244,11652,495,Apolda,51.0227878,11.5129742
99.06,22789,11185,11604,230,Rotenburg (Wümme),53.1108906,9.4049292
165.55,22738,11504,11234,137,Burg,49.9600346,6.3512069
22.39,22665,10768,11897,1012,Herdecke,51.4001119,7.4330062
144.74,22609,11128,11481,156,Eisleben,51.5283282,11.5465911
122.88,22607,11336,11271,184,Büdingen,50.2972353,9.0990829
73.56,22586,11223,11363,307,Bad Rappenau,49.2393031,9.101268
12.13,22551,11295,11256,1859,Eschborn,50.1504737,8.5607767
34.55,22530,11150,11380,652,Metzingen,48.5397247,9.2831201
31.97,22467,10915,11552,703,Heide,54.1948848,9.0928251
43.16,22339,10864,11475,518,Quickborn,54.0111091,9.2114907
104.69,22312,11121,11191,213,Donaueschingen,47.9534194,8.4959257
48.47,22266,10808,11458,459,Waldkirch,48.0939396,7.9610142
88.58,22252,11130,11122,251,Eppingen,49.1369473,8.90956
85.57,22242,11155,11087,260,Versmold,52.0416747,8.1493878
92.83,22222,10804,11418,239,Aichach,48.4591478,11.1309953
69.7,22198,10952,11246,318,Halle (Westf.),52.0603847,8.3615861
53.86,22159,10785,11374,411,Radevormwald,51.2029228,7.3571392
203.77,22040,10791,11249,108,Soltau,52.9844301,9.8399034
46.55,22035,10514,11521,473,Sonthofen,47.5135363,10.281931
66.17,21993,10844,11149,332,Elsdorf,50.9371308,6.5698302
35.69,21971,10828,11143,616,Bad Krozingen,47.9118288,7.7033313
636.27,21926,10918,11008,34,Gardelegen,52.5269433,11.3927377
16.41,21894,10863,11031,1334,Eislingen/Fils,48.6986798,9.7065009
55.4,21865,10880,10985,395,Günzburg,48.4555244,10.2766213
29.42,21860,10868,10992,743,Mühldorf a.Inn,48.2405007,12.5250991
51.62,21807,10651,11156,422,Glauchau,50.8199031,12.5397873
72.43,21776,10646,11130,301,Xanten,51.661519,6.4543203
42.84,21766,10888,10878,508,Waghäusel,49.2485721,8.516277
30.85,21752,10457,11295,705,Seligenstadt,50.0347055,8.9593719
22.99,21751,10652,11099,946,Flörsheim am Main,50.0296,8.4265
97.89,21749,10825,10924,222,Geseke,51.6395322,8.512578
78.24,21733,10820,10913,278,Stadtallendorf,50.8251982,9.0292315
180.38,21643,11253,10390,120,Zossen,52.2159073,13.4488958
34.84,21631,10694,10937,621,Hockenheim,49.3188892,8.5475467
21.58,21620,10256,11364,1002,Eckernförde,54.4716456,9.8374947
21.5,21609,10539,11070,1005,Schwetzingen,49.3832919,8.5735135
48.57,21551,10444,11107,444,Traunstein,47.8695272,12.6484621
170.99,21524,11108,10416,126,Büren,51.5525333,8.5591919
65.52,21503,9998,11505,328,Bad Harzburg,51.8797558,10.5875671
202.32,21497,10388,11109,106,Spremberg/Grodk,51.5714513,14.3804302
470.91,21483,10571,10912,46,Zerbst/Anhalt,51.9640339,12.085502
109.86,21452,10720,10732,195,Rees,51.7581242,6.3956605
89.7,21424,10587,10837,239,Wildeshausen,52.897103,8.4364342
12.24,21410,10425,10985,1749,Puchheim,48.1704908,11.3526351
102.54,21382,10535,10847,209,Osterode am Harz,51.72784,10.2508204
101.01,21375,10578,10797,212,Zülpich,50.6922459,6.6472694
21.68,21295,10718,10577,982,Germersheim,49.2222749,8.36659
80.7,21231,10642,10589,263,Schramberg,48.225478,8.3852168
159.46,21217,9928,11289,133,Waren (Müritz),53.5156249,12.6850606
201.21,21183,10452,10731,105,Sondershausen,51.3666041,10.8668419
63.76,21142,10452,10690,332,Herborn,49.7674455,7.2952179
118.3,21059,10494,10565,178,Wipperfürth,51.1155182,7.3879068
68.09,21053,10483,10570,309,Nördlingen,48.8516578,10.4885873
107.54,21049,10599,10450,196,Hörstel,52.2973664,7.5862462
45.06,21021,10433,10588,467,Traunreut,47.9623271,12.5924162
86.84,21018,10380,10638,242,Groß-Umstadt,49.86477,8.95669
32.27,21009,10145,10864,651,Wülfrath,51.2818569,7.0328063
46.61,21000,10258,10742,451,Luckenwalde,52.0902045,13.1741882
50.03,20979,10203,10776,419,Mössingen,48.4069119,9.0602912
68.79,20932,10196,10736,304,Schortens,53.5366547,7.9467348
44.0,20927,10978,9949,476,Dingolfing,48.6300801,12.4977434
29.88,20894,10202,10692,699,Bruchköbel,50.1845,8.9369
210.16,20835,10236,10599,99,Wittmund,53.5364786,7.7462334
65.62,20793,10344,10449,317,Werdau,50.7361377,12.3763847
79.25,20791,10455,10336,262,Stadtlohn,51.9928346,6.9173072
108.55,20786,10203,10583,191,Bad Waldsee,47.9209556,9.7542772
41.24,20724,10239,10485,503,Enger,52.1394015,8.5588818
32.31,20695,10065,10630,641,Rheinstetten,48.968549,8.3097117
28.06,20682,10291,10391,737,Schifferstadt,49.3858742,8.3705675
115.69,20653,10235,10418,179,Meinerzhagen,51.1063495,7.6408956
46.73,20652,10186,10466,442,Nidderau,50.2290263,8.8762327
25.88,20561,9839,10722,794,Coswig,51.1267305,13.5783983
152.85,20481,9746,10735,134,Burgwedel,52.5,9.86667
56.23,20450,10058,10392,364,Fröndenberg/Ruhr,51.4739253,7.765505
122.16,20403,10083,10320,167,Lichtenfels,50.14568,11.06382
20.71,20394,10195,10199,985,Korntal-Münchingen,48.8432607,9.1068611
105.63,20392,10398,9994,193,Ochtrup,52.2102308,7.188806
139.89,20385,9771,10614,146,Neustrelitz,53.3617163,13.0630004
44.07,20358,10177,10181,462,Giengen an der Brenz,48.6208515,10.2442196
95.64,20320,9972,10348,212,Duderstadt,51.5123672,10.2610699
90.9,20301,9879,10422,223,Telgte,51.983522,7.784859
34.47,20273,9737,10536,588,Reichenbach im Vogtland,50.6221096,12.3319985
71.25,20262,10091,10171,284,Tettnang,47.6716558,9.5891158
67.93,20238,9816,10422,298,Schopfheim,47.6500525,7.8216997
69.1,20237,10053,10184,293,Oberkirch,48.5308586,8.078657
84.86,20220,9803,10417,238,Greiz,50.7783814,12.0763533
88.23,20217,10052,10165,229,Holzminden,51.8989989,9.5741099
108.21,20202,9947,10255,187,Blieskastel,49.2370918,7.2599036
18.39,20169,9364,10805,1097,Bad Schwartau,53.9196435,10.6978692
77.04,20108,10018,10090,261,Donauwörth,48.7180364,10.7807299
63.32,20081,9771,10310,317,Waldbröl,50.8751813,7.6159479
75.59,20070,9917,10153,266,Dillingen a.d.Donau,48.577185,10.4943532
115.79,20053,9955,10098,173,Leinefelde-Worbis,51.4149256,10.3194472
43.85,20027,10113,9914,457,Moosburg a.d.Isar,48.4667,11.9333
62.45,20013,9715,10298,320,Borna,51.1241649,12.4999055
105.38,19984,10298,9686,190,Schmalkalden,50.7213643,10.4510467
24.71,19964,10239,9725,808,Bad Friedrichshall,49.2280136,9.2101479
22.05,19941,9753,10188,904,Dillingen/ Saar,49.3552721,6.7243197
43.0,19896,9813,10083,463,Sarstedt,52.2340379,9.8534254
189.88,19885,9948,9937,105,Oschersleben (Bode),52.0266526,11.227781
58.19,19882,9923,9959,342,Mayen,50.3283544,7.2215134
78.9,19837,9956,9881,251,Rhede,53.0583171,7.2734909
9.99,19817,9639,10178,1984,Schenefeld,54.0484989,9.4703368
125.56,19812,9893,9919,158,Ennigerloh,51.8359553,8.0255988
17.01,19774,9714,10060,1162,Gerlingen,48.7983947,9.0624386
57.91,19756,9574,10182,341,Müllheim im Markgräflerland,47.8099613,7.6257276
68.9,19754,9539,10215,287,Bückeburg,52.2611037,9.0488959
41.4,19745,9523,10222,477,Bad Aibling,47.8640504,12.0097685
49.64,19718,9962,9756,397,Wittlich,49.9850353,6.88844
182.22,19704,10152,9552,108,Marsberg,51.4602168,8.8552071
36.43,19698,9426,10272,541,Aue-Bad Schlema,50.6039112,12.683981
102.82,19683,9669,10014,191,Torgau,51.5581272,13.0046538
106.73,19596,9770,9826,184,Haiger,50.7752801,8.2129059
61.99,19596,9384,10212,316,Bad Pyrmont,51.9850503,9.2434635
25.05,19566,9293,10273,781,Mölln,53.62892,10.6880174
268.15,19563,9768,9795,73,Nauen,52.6061065,12.8772599
53.12,19548,9709,9839,368,Sulzbach-Rosenberg,49.4992468,11.7470259
42.43,19541,9629,9912,461,Wassenberg,51.1007618,6.1561074
35.22,19530,9737,9793,555,Alzey,49.7454561,8.1130036
9.13,19499,9465,10034,2136,Wolfratshausen,47.9104632,11.4266377
115.3,19496,9679,9817,169,Bad Driburg,51.7366427,9.0175012
19.81,19494,9601,9893,984,Burghausen,48.1588645,12.8329419
57.92,19480,9645,9835,336,Sachsenheim,48.9654062,9.0583956
66.41,19475,9618,9857,293,Hechingen,48.3525529,8.9642047
28.15,19470,9415,10055,692,Annaberg-Buchholz,50.5788781,13.0106108
63.26,19435,9294,10141,307,Eschwege,51.1733518,10.0680632
19.03,19426,9649,9777,1021,Heusenstamm,50.0537652,8.8236013
19.83,19414,9410,10004,979,Kolbermoor,47.8556623,12.0595795
30.8,19360,9411,9949,629,Bad Tölz,47.7610013,11.559607
43.17,19340,9560,9780,448,Weil der Stadt,48.7501041,8.8707147
81.47,19234,9918,9316,236,Schkeuditz,51.3963509,12.2216292
30.14,19221,9377,9844,638,Pfullingen,48.4656748,9.2254982
157.13,19188,9502,9686,122,Haldensleben,52.2911243,11.4132719
102.33,19185,9313,9872,187,Seesen,51.8905566,10.1703902
234.92,19169,9273,9896,82,Schneverdingen,53.1165973,9.7925898
64.21,19108,9886,9222,298,Lebach,49.4132377,6.9091348
41.92,19087,9229,9858,455,Bad Reichenhall,47.7222676,12.8760923
87.56,19052,9381,9671,218,Sömmerda,51.1618258,11.1174874
149.21,19034,9166,9868,128,Blankenburg (Harz),51.7902676,10.9551991
95.15,19033,9651,9382,200,Marktoberdorf,47.7780871,10.6188796
150.42,19023,9534,9489,126,Bremervörde,53.4850249,9.1362085
142.97,19022,9191,9831,133,Prenzlau,53.3167,13.866575
27.33,19005,9310,9695,695,Burscheid,51.0824722,7.1212314
97.58,18931,9331,9600,194,Weißenburg i.Bay.,49.0305748,10.9718974
18.87,18891,9365,9526,1001,Bad Segeberg,53.9422672,10.3137943
31.73,18885,9147,9738,595,Hemmingen,52.3212183,9.7454815
275.52,18833,9523,9310,68,Bad Berleburg,51.0478493,8.3917759
29.83,18824,9207,9617,631,Radeberg,51.1151413,13.9175257
102.55,18821,8885,9936,184,Bad Dürkheim,49.4632944,8.1705063
19.47,18810,9255,9555,966,Hochheim am Main,50.0277,8.3587
59.3,18787,9202,9585,317,Alzenau,50.085868,9.0813749
11.43,18776,9232,9544,1643,Uetersen,53.6851608,9.669827
72.88,18679,9211,9468,256,Alfeld (Leine),51.9863077,9.8247473
84.79,18661,9443,9218,220,Schwalmstadt,50.9128419,9.1882126
11.21,18656,9152,9504,1664,Glinde,53.5411468,10.213583
31.15,18655,9210,9445,599,Renningen,48.7648163,8.9347008
13.97,18622,8903,9719,1333,Vellmar,51.3622487,9.4692331
37.89,18621,9044,9577,491,Bergneustadt,51.0207425,7.6490729
36.39,18578,9214,9364,511,Illertissen,48.221764,10.1058969
18.58,18569,8820,9749,999,Kronberg im Taunus,50.1907415,8.5182779
120.32,18556,9071,9485,154,Hessisch Oldendorf,52.1698382,9.2506531
44.57,18539,9125,9414,416,Konz,49.6984949,6.5736454
37.62,18536,8982,9554,493,Lahnstein,50.3090305,7.6044602
61.14,18479,8993,9486,302,Crimmitschau,50.8162378,12.3867217
131.62,18405,9085,9320,140,Wörth am Rhein,49.0543232,8.2667399
76.93,18403,9265,9138,239,Vlotho,52.1664861,8.8619172
124.81,18270,8826,9444,146,Parchim,53.4258455,11.8475244
23.95,18243,8785,9458,762,Püttlingen,49.287307,6.8827786
138.93,18203,8923,9280,131,Buchen (Odenwald),49.5222974,9.3243187
75.26,18199,9099,9100,242,Schrobenhausen,48.5613407,11.2654488
38.0,18199,8930,9269,479,Pohlheim,50.5165524,8.7345921
124.86,18138,9131,9007,145,Frankenberg (Eder),51.0771933,8.7908312
92.84,18127,9206,8921,195,Sigmaringen,48.0855844,9.2178879
130.36,18077,8868,9209,139,Großenhain,51.2911845,13.5317153
86.29,18061,8995,9066,209,Vilshofen an der Donau,48.633762,13.1868461
14.81,18036,8780,9256,1218,Freilassing,47.8409723,12.9823914
50.26,18022,8920,9102,359,Bobingen,48.2687941,10.8337852
12.09,17807,8591,9216,1473,Oberasbach,49.4303112,10.967555
118.33,17768,8953,8815,150,Nidda,50.1254749,8.6154664
33.38,17762,8788,8974,532,Werdohl,51.257732,7.7642148
24.2,17744,8953,8791,733,Trossingen,48.07506,8.6362987
54.6,17738,8846,8892,325,Freudenberg,49.7486131,9.3261061
97.34,17724,8770,8954,182,Bad Saulgau,48.0158071,9.5010309
110.69,17721,8600,9121,160,Forst (Lausitz)/Baršć (Łužyca),51.7438586,14.6455395
104.39,17686,8807,8879,169,Damme,52.5212651,8.1957974
57.79,17683,8556,9127,306,Bad Wörishofen,48.0059852,10.5921263
31.09,17663,8675,8988,568,Bexbach,49.347299,7.2548948
25.35,17637,8443,9194,696,Bad Säckingen,47.5525538,7.9495387
104.7,17608,8627,8981,168,Diepholz,52.7478987,8.7615261
80.69,17593,8840,8753,218,Cham,49.2178194,12.6663832
66.85,17579,8744,8835,263,Babenhausen,48.143242,10.2540507
28.17,17577,9060,8517,624,Garching b.München,48.2513878,11.6509662
150.83,17568,8486,9082,116,Bad Münstereifel,50.5545674,6.7636511
55.52,17562,8464,9098,316,Auerbach/Vogtl.,50.5087816,12.400153
107.97,17511,8606,8905,162,Bad Münder am Deister,52.1952894,9.4633959
120.1,17473,8597,8876,145,Bad Wildungen,51.1029078,9.0940685
80.84,17467,8809,8658,216,Gescher,51.956874,7.0038803
47.55,17465,8775,8690,367,Bitburg,49.9732762,6.524947
69.73,17402,8571,8831,250,Stockach,47.8530941,9.0134524
41.1,17399,8492,8907,423,Sinzig,50.5452042,7.2490828
33.21,17387,8606,8781,524,Remagen,50.5792112,7.2286788
11.65,17370,8537,8833,1491,Schwarzenbek,53.503122,10.4785643
15.41,17365,8956,8409,1127,Kelsterbach,50.065151,8.5296632
129.37,17338,8444,8894,134,Bad Langensalza,51.1085823,10.6454374
90.15,17329,8459,8870,192,Horn-Bad Meinberg,51.8801277,8.9731695
41.38,17296,8169,9127,418,Eutin,54.1364642,10.6159077
32.69,17287,8417,8870,529,Oerlinghausen,51.9492295,8.673579
70.87,17260,8588,8672,244,Heilbad Heiligenstadt,51.3756186,10.138224
49.52,17254,8339,8915,348,Marktredwitz,50.0009915,12.0856433
82.72,17237,8340,8897,208,Gunzenhausen,49.1147095,10.7545933
24.12,17208,8521,8687,713,Bendorf,50.4238296,7.5732901
13.94,17143,8504,8639,1230,Ginsheim-Gustavsburg,49.9845346,8.3254964
119.75,17130,8722,8408,143,Hünfeld,50.65546,9.7764627
100.23,17094,8548,8546,171,Kelheim,48.91849,11.8722777
46.77,17040,8257,8783,364,Eltville am Rhein,50.0275441,8.1189741
50.63,16982,8285,8697,335,Wittenberge,52.9983723,11.7507204
34.46,16980,8417,8563,493,Bürstadt,49.6531823,8.4747076
66.98,16924,8330,8594,253,Kronach,50.2397846,11.3277669
25.73,16909,8284,8625,657,Penzberg,47.7518502,11.3763014
51.01,16884,8191,8693,331,Bad Lippspringe,51.7833,8.81667
98.3,16861,8366,8495,172,Kamenz / Kamjenc,51.270139,14.0948628
25.05,16831,8036,8795,672,Königstein im Taunus,50.195133,8.4628165
45.75,16795,8537,8258,367,Brackenheim,49.0784228,9.067437
168.85,16794,8372,8422,99,Bassum,52.8495881,8.728382
27.7,16729,8253,8476,604,Reinheim,49.8364879,8.8238238
137.94,16721,8216,8505,121,Thale,51.7527606,11.037722
69.0,16715,8056,8659,242,Wurzen,51.3709574,12.7410574
11.07,16667,8165,8502,1506,Heidenau,53.3139784,9.6531686
55.61,16606,8425,8181,299,Blaustein,48.4159247,9.9187625
90.95,16578,8177,8401,182,Kirchhain,50.83982,8.9153
12.6,16564,8409,8155,1315,Raunheim,50.0097685,8.4499439
74.0,16544,8262,8282,224,Straelen,51.4439341,6.2694388
68.86,16509,8077,8432,240,Pocking,48.4015189,13.3107683
89.41,16484,8110,8374,184,Erwitte,51.61431,8.3396662
75.18,16436,8339,8097,219,Künzelsau,49.2803765,9.6901512
133.49,16420,8172,8248,123,Marienberg,50.6507279,13.163188
16.07,16368,8066,8302,1019,Sulzbach/ Saar,49.2995623,7.0614007
99.99,16321,8112,8209,163,Bad Bentheim,52.3024786,7.1605921
15.82,16320,7825,8495,1032,Bargteheide,53.7279671,10.2618075
71.91,16320,8006,8314,227,Kierspe,51.1278531,7.6006513
44.42,16315,8081,8234,367,Altena,51.2990263,7.6734841
173.92,16310,8152,8158,94,Brakel,51.7168889,9.1841762
77.23,16284,8012,8272,211,Halver,51.1874423,7.4987312
13.14,16227,7941,8286,1235,Freiberg am Neckar,48.9345539,9.1922557
56.42,16226,8170,8056,288,Mindelheim,48.0464164,10.4882504
43.99,16210,7712,8498,368,Guben,51.9503235,14.7153567
129.71,16205,8035,8170,125,Alsfeld,50.7523545,9.268355
46.85,16201,7798,8403,346,Eilenburg,51.4586736,12.6344389
14.4,16186,7675,8511,1124,Preetz,54.3506105,12.9907315
18.58,16162,8139,8023,870,Erlensee,50.1624394,8.9846455
12.15,16159,7997,8162,1330,Wendlingen am Neckar,48.6727602,9.3838404
58.46,16145,7911,8234,276,Markranstädt,51.3026177,12.2204644
113.3,16126,8020,8106,142,Schlüchtern,50.3517,9.5613
43.5,16072,7613,8459,369,Füssen,47.5675998,10.6993217
18.06,16010,7870,8140,886,Marbach am Neckar,48.9402085,9.256396
54.59,16007,7900,8107,293,Breisach am Rhein,48.0291415,7.5806123
19.91,15995,7891,8104,803,Walldorf,49.3038134,8.6433518
126.47,15984,7925,8059,126,Bad Arolsen,51.3649894,9.0376388
86.98,15975,7893,8082,184,Michelstadt,49.68841,9.05647
81.23,15916,7934,7982,196,Weener,53.1645939,7.3536239
135.14,15890,7719,8171,118,Zeulenroda-Triebes,50.6562697,12.0058399
106.6,15865,7816,8049,149,Drensteinfurt,51.7972657,7.7418147
77.52,15864,7609,8255,205,Finsterwalde,51.6315282,13.707358
131.13,15860,7853,8007,121,Königslutter am Elm,52.2499307,10.8171691
111.22,15860,7919,7941,143,Wadern,49.5410205,6.8889313
137.48,15859,8007,7852,115,Rahden,52.4333,8.61667
75.03,15792,7981,7811,210,Langenau,48.4995693,10.1210951
139.51,15774,7711,8063,113,Lübbenau/Spreewald / Lubnjow/Błota,51.8680114,13.9689477
26.26,15768,7800,7968,600,Ebersbach an der Fils,48.7149061,9.5259189
33.22,15759,7617,8142,474,Taucha,51.3799905,12.4936336
19.73,15749,7421,8328,798,Neustadt in Holstein,54.1029898,10.8186738
48.59,15746,7838,7908,324,Altdorf b.Nürnberg,49.3858107,11.3564341
46.31,15740,7560,8180,340,Schwarzenberg/Erzgeb.,50.538248,12.7826635
122.83,15729,7433,8296,128,Ribnitz-Damgarten,54.2433326,12.4319733
23.08,15723,7682,8041,681,Dieburg,49.8949312,8.8368946
36.9,15720,7682,8038,426,Bad Neustadt a.d.Saale,50.322637,10.2164873
86.37,15626,7612,8014,181,Hofgeismar,51.4972178,9.4280731
11.49,15614,7663,7951,1359,Stadtbergen,48.3666284,10.8442814
379.59,15604,7494,8110,41,Templin,53.1193496,13.5005559
74.88,15593,7615,7978,208,Boppard,50.2312823,7.5885884
6.47,15566,7554,8012,2406,Schwalbach am Taunus,50.1490109,8.5357434
5.7,15543,7676,7867,2727,Eppelheim,49.4025,8.63306
61.54,15517,7853,7664,252,Mainburg,48.640589,11.7820705
24.14,15451,7527,7924,640,Bad Bramstedt,53.9167,9.88333
43.69,15436,8637,6799,353,Clausthal-Zellerfeld,51.8070405,10.3364483
99.1,15417,7757,7660,156,Blomberg,51.9434473,9.0967908
194.52,15413,7891,7522,79,Munster,51.9625101,7.6251879
90.42,15353,7671,7682,170,Lohr a.Main,49.9947528,9.573777
43.27,15329,7333,7996,354,Gehrden,52.313508,9.6008438
41.88,15313,7563,7750,366,Ober-Ramstadt,49.8152,8.7548
31.61,15309,7498,7811,484,Schriesheim,49.4751705,8.6611149
99.56,15197,7560,7637,153,Dorfen,48.272779,12.1505507
85.39,15190,7647,7543,178,Isny im Allgäu,47.6925666,10.039203
38.3,15102,7393,7709,394,Brake (Unterweser),53.3256109,8.4806296
88.81,15101,7438,7663,170,Fritzlar,51.1537071,9.2645106
28.17,15099,7570,7529,536,Markgröningen,48.9050626,9.0808114
126.78,15097,7392,7705,119,Witzenhausen,51.3331901,9.8434192
55.81,15095,7384,7711,270,Usingen,50.350795,8.5231684
61.89,15089,7465,7624,244,Neustadt b.Coburg,50.3283477,11.1226908
125.99,15088,7521,7567,120,Landsberg,48.0497474,10.8768728
182.24,15083,7682,7401,83,Bad Wurzach,47.9084031,9.8966021
98.15,15062,7443,7619,153,Karlstadt,49.9616823,9.7655121
63.43,14992,7152,7840,236,Weißwasser/O.L.,51.5028807,14.6373221
108.76,14960,7434,7526,138,Langelsheim,51.9356917,10.3296997
93.53,14949,7651,7298,160,Neustadt a.d.Donau,48.8091474,11.7638092
55.5,14926,7313,7613,269,Schwabmünchen,48.1805562,10.7578121
42.24,14913,7033,7880,353,Jever,53.5736426,7.9020696
116.93,14860,7347,7513,127,Münsingen,48.4128592,9.4947894
19.51,14851,7083,7768,761,Stein,49.4139647,11.0130276
50.52,14770,7420,7350,292,Hückeswagen,51.1504872,7.3413999
24.79,14753,7282,7471,595,Uhingen,48.7042331,9.5856424
86.07,14727,7157,7570,171,Selb,50.169121,12.1297769
81.12,14714,7296,7418,181,Hilchenbach,50.9935863,8.107365
100.11,14712,7456,7256,147,Homberg (Efze),51.0117227,9.4048406
60.26,14685,7551,7134,244,Abensberg,48.8332409,11.8570782
55.92,14684,7335,7349,263,Oberndorf am Neckar,48.2908613,8.5711222
67.12,14678,7128,7550,219,Pattensen,52.2636263,9.7606529
33.77,14677,7138,7539,435,Montabaur,50.4362219,7.8302494
80.59,14635,7261,7374,182,Kraichtal,49.1319246,8.7375729
26.23,14630,7162,7468,558,Langenselbold,50.1780814,9.04333
81.44,14622,7045,7577,180,Immenstadt i.Allgäu,47.5713421,10.1888003
9.75,14614,7275,7339,1499,Neutraubling,48.9926567,12.1990753
81.6,14613,7211,7402,179,Wilsdruff,51.0524125,13.5362765
20.61,14606,7129,7477,709,Tornesch,53.6959113,9.7114755
94.44,14596,7264,7332,155,Lauda-Königshofen,49.5577854,9.7190669
10.64,14590,7267,7323,1371,Plochingen,48.711173,9.4184961
78.08,14566,7396,7170,187,Sassenberg,51.9882058,8.0407212
30.29,14552,6889,7663,480,Ratzeburg,53.7011061,10.774288
93.26,14527,7170,7357,156,Burglengenfeld,49.2071077,12.03996
45.56,14522,7294,7228,319,Ottweiler,49.4030447,7.1631469
81.15,14489,7066,7423,179,Eberbach,49.4635303,8.9855203
118.0,14481,7167,7314,123,Olsberg,51.355148,8.4893388
44.35,14439,7157,7282,326,Eggenfelden,48.4031909,12.7626208
82.03,14438,7181,7257,176,Gernsbach,48.7636394,8.3379924
40.91,14406,7161,7245,352,Markdorf,47.7206084,9.3917257
84.4,14402,7290,7112,171,Landau a.d.Isar,48.6699678,12.6912228
82.16,14398,6946,7452,175,Sandersdorf-Brehna,51.5911163,12.2359037
40.35,14389,7075,7314,357,Spenge,52.1419264,8.4830331
78.9,14389,6970,7419,182,Löbau,51.0947288,14.6692423
74.13,14376,7282,7094,194,Zeven,53.2954396,9.2816165
36.12,14359,7033,7326,398,Neu-Anspach,50.2971783,8.4988614
29.58,14348,7066,7282,485,Grafing b.München,48.0453808,11.966071
77.61,14310,6988,7322,184,Lich,50.50516,8.84162
71.15,14248,7080,7168,200,Murrhardt,48.9797657,9.5794661
54.6,14229,6928,7301,261,Bad Camberg,50.305569,8.280525
88.2,14199,7090,7109,161,Kalkar,51.7388793,6.2927546
41.26,14198,7081,7117,344,Mittweida,50.9854597,12.9810458
103.99,14174,6982,7192,136,Dippoldiswalde,50.8950479,13.6633335
88.12,14174,7077,7097,161,Leuna,51.3233638,12.0195081
18.09,14169,6972,7197,783,Grünstadt,49.5653661,8.1634571
113.59,14166,7012,7154,125,Uslar,51.658901,9.6347785
23.69,14134,6955,7179,597,Vöhringen,48.2833039,10.0832982
36.18,14119,7021,7098,390,Buchloe,48.0373762,10.7282761
63.09,14107,7039,7068,224,Melsungen,51.1425944,9.5833158
61.52,14099,6886,7213,229,Erbach,50.0261094,7.681587
55.44,14089,6895,7194,254,Oschatz,51.2979627,13.1081103
25.24,14088,6853,7235,558,Lorsch,49.6546967,8.5682813
53.72,14088,7099,6989,262,Weißenhorn,48.3044877,10.1601492
63.29,14080,7082,6998,222,Erbach,50.0261094,7.681587
70.87,14063,6993,7070,198,Höchstadt a.d.Aisch,49.7035803,10.8047235
43.57,14043,6962,7081,322,Aßlar,50.609245,8.447572
17.81,14032,6737,7295,788,Schwentinental,54.2900155,10.2254279
23.35,14028,7019,7009,601,Schneeberg,49.6389609,9.2481247
79.97,14020,6900,7120,175,Rotenburg a. d. Fulda,51.018118,9.7487639
420.21,13994,6922,7072,33,Wittstock/Dosse,53.162999,12.4868962
48.8,13985,6898,7087,287,Ettenheim,48.2552348,7.81349
52.66,13982,6956,7026,266,Haßfurt,50.0318698,10.5065562
120.85,13967,6667,7300,116,Lübben (Spreewald) / Lubin (Błota),51.9418987,13.8963805
353.93,13966,6963,7003,39,Jessen (Elster),51.7931158,12.9590741
58.59,13960,6915,7045,238,Bad Soden-Salmünster,50.2801792,9.3704249
89.72,13953,7079,6874,156,Hilpoltstein,49.188964,11.1892243
89.3,13951,6805,7146,156,Lauchhammer,51.4977774,13.7400618
17.96,13947,6871,7076,777,Quakenbrück,52.6757127,7.9567402
44.64,13940,6838,7102,312,Krumbach (Schwaben),48.2430587,10.3631004
89.22,13940,6818,7122,156,Grünberg,50.6137167,8.945947
18.58,13937,6725,7212,750,Hohenstein-Ernstthal,50.8021139,12.7072907
34.02,13921,6945,6976,409,Solms,50.5333914,8.4073302
50.54,13910,7099,6811,275,Philippsburg,49.2367495,8.4546679
93.71,13908,6843,7065,148,Bebra,50.9835038,9.8388054
101.98,13883,6772,7111,136,Lauterbach (Hessen),50.6656227,9.4236655
47.79,13867,6675,7192,290,Eichstätt,48.8933417,11.1838965
65.62,13862,6836,7026,211,Frankenberg/Sa.,50.9110365,13.0331023
13.39,13841,6805,7036,1034,Holzgerlingen,48.6392119,9.0115732
5.8,13836,6864,6972,2386,Asperg,48.9058591,9.1350865
143.52,13823,6863,6960,96,Löningen,52.7363493,7.7570655
19.81,13797,6725,7072,696,Meerane,50.8427835,12.4581578
18.5,13795,6924,6871,746,Spaichingen,48.0730713,8.7391941
181.31,13794,6917,6877,76,Beelitz,52.2288191,12.9569266
62.08,13793,6659,7134,222,Bad Dürrheim,48.0222311,8.5299837
324.24,13775,6618,7157,42,Angermünde,53.017276,13.9981503
96.95,13760,6787,6973,142,Sendenhorst,51.8444362,7.8273931
99.98,13741,6861,6880,137,Pegnitz,49.75649,11.540944
90.31,13717,6855,6862,152,Biedenkopf,50.91958,8.53771
52.35,13694,6822,6872,262,Pfarrkirchen,48.4320329,12.9386266
188.44,13669,6816,6853,73,Wanzleben-Börde,52.0758511,11.4205222
159.43,13663,6737,6926,86,Haselünne,52.6718718,7.4830538
90.5,13654,6728,6926,151,Pfullendorf,47.924349,9.2559822
51.49,13650,6544,7106,265,Bergen auf Rügen,54.4172673,13.4305634
232.69,13646,6704,6942,59,Genthin,52.4063738,12.1561742
24.19,13645,6651,6994,564,Eppstein,50.155,8.3803
22.77,13631,6776,6855,599,Linden,50.6019526,7.8504832
26.16,13629,6676,6953,521,Neckargemünd,49.3954054,8.7965893
69.29,13621,6766,6855,197,Tauberbischofsheim,49.6229682,9.6627138
82.94,13610,6579,7031,164,Wiesmoor,53.4114442,7.7309444
94.53,13607,6675,6932,144,Schmölln,50.9078332,12.3370882
61.21,13523,6570,6953,221,Neustadt a.d.Aisch,49.5800045,10.6087584
67.18,13523,6618,6905,201,Bad Salzdetfurth,52.0595144,10.0064728
164.39,13520,6674,6846,82,Bergen,49.7808936,7.4176059
135.95,13504,6809,6695,99,Bad Laasphe,50.9271541,8.4123648
37.03,13498,6641,6857,365,Hettstedt,51.6500047,11.4999986
249.96,13479,6771,6708,54,Oebisfelde-Weferlingen,52.3678102,11.1099786
72.8,13468,6702,6766,185,Dinklage,52.6626633,8.1212801
22.22,13468,6769,6699,606,Weinsberg,49.1504172,9.2865471
110.83,13430,6636,6794,121,Sulingen,52.6828374,8.8018923
112.29,13411,6665,6746,119,Wolfhagen,51.3333355,9.1968854
57.51,13395,6731,6664,233,Weilburg,50.4847448,8.2659245
19.45,13387,6738,6649,688,Schüttorf,52.321619,7.2220864
70.75,13381,6758,6623,189,Velen,51.8957136,6.9839073
53.28,13299,6799,6500,250,Östringen,49.2192418,8.7097172
52.43,13298,6406,6892,254,Olfen,51.7076224,7.3788047
98.09,13277,6562,6715,135,Beverungen,51.6676535,9.3759072
35.9,13270,6651,6619,370,Plattling,48.7766852,12.8733655
223.06,13267,6601,6666,59,Zehdenick,52.9794838,13.3348959
121.67,13233,6654,6579,109,Schleiden,50.5285919,6.4761556
119.61,13224,6852,6372,111,Roding,49.1964174,12.5166987
185.5,13218,6407,6811,71,Fehmarn,54.4687375,11.1340848
59.85,13203,6544,6659,221,St. Georgen im Schwarzwald,48.1257642,8.3330247
45.33,13199,6465,6734,291,Rosbach v. d. Höhe,50.2774771,8.6974397
103.38,13181,6739,6442,128,Treuchtlingen,48.9554435,10.9089888
58.63,13179,6530,6649,225,Herbrechtingen,48.6226932,10.1761696
23.07,13172,6283,6889,571,Altötting,48.2268085,12.6757914
35.64,13113,6430,6683,368,Wehr,47.6286078,7.9046417
18.8,13112,6603,6509,697,Wasserburg a.Inn,48.0615171,12.220026
32.85,13105,6217,6888,399,Bad Doberan,54.105858,11.9026057
40.99,13093,6699,6394,319,Hadamar,50.4587,8.05793
50.79,13061,6514,6547,257,Wächtersbach,50.2724,9.2857
65.43,13056,6488,6568,200,Linnich,50.9806294,6.2676208
86.78,13033,6430,6603,150,Hungen,50.4696168,8.9171014
193.41,13004,6546,6458,67,Südliches Anhalt,51.6916959,12.0666121
114.38,12952,6545,6407,113,Twistringen,52.7992604,8.6421452
49.97,12947,6393,6554,259,Rödental,50.2971914,11.0428276
16.83,12923,6482,6441,768,Besigheim,48.9996364,9.1417523
527.78,12885,6532,6353,24,Möckern,52.1405163,11.9532769
137.21,12875,6476,6399,94,Feuchtwangen,49.1678603,10.3313268
105.72,12798,6501,6297,121,Hessisch Lichtenau,51.1927404,9.7517183
147.95,12792,6432,6360,86,Winterberg,51.1930723,8.5338466
71.88,12783,6278,6505,178,Herzberg am Harz,51.6565219,10.3428415
22.9,12772,6227,6545,558,Hersbruck,49.5085843,11.4285065
21.34,12769,6298,6471,598,Schongau,47.8118973,10.8972133
78.24,12766,6221,6545,163,Bad Windsheim,49.5020006,10.4175301
87.62,12760,6401,6359,146,Sulz am Neckar,48.3617509,8.6314329
55.42,12755,6340,6415,230,Bad Urach,48.4937953,9.3978845
23.42,12733,6274,6459,544,Velten,52.6882194,13.1775867
8.78,12726,6390,6336,1449,Tamm,48.9204307,9.1158361
19.0,12704,6144,6560,669,Ladenburg,49.4724349,8.6106455
176.48,12661,6116,6545,72,Jüterbog,51.9916493,13.0801128
79.11,12657,6412,6245,160,Blaubeuren,48.4121233,9.7847091
65.21,12651,6396,6255,194,Brunsbüttel,53.8972549,9.1395423
75.69,12643,6208,6435,167,Steinheim,51.8660478,9.0942767
68.84,12621,6312,6309,183,Vilsbiburg,48.448482,12.355795
72.28,12594,6309,6285,174,Gladenbach,50.78141,8.57886
14.29,12565,6085,6480,879,Röthenbach a.d.Pegnitz,49.485011,11.2474853
82.46,12565,6311,6254,152,Borken (Hessen),51.0579472,9.2918981
161.3,12546,6283,6263,78,Bad Wünnenberg,51.5169114,8.6986809
40.84,12527,6161,6366,307,Ebersberg,48.0782763,11.9694372
44.1,12520,6255,6265,284,Neuenburg am Rhein,47.8155916,7.5627871
60.62,12512,6201,6311,206,Waltershausen,50.897728,10.5035734
68.76,12456,6137,6319,181,Preußisch Oldendorf,52.3048433,8.4971557
69.83,12447,6332,6115,178,Laichingen,48.4896773,9.6861474
52.99,12445,6126,6319,235,Zella-Mehlis,50.6574735,10.6727728
10.89,12443,6178,6265,1143,Wernau (Neckar),48.6943334,9.4189845
78.64,12420,5974,6446,158,Ludwigslust,53.3300229,11.4993644
89.64,12395,6113,6282,138,Titisee-Neustadt,47.9173421,8.1735161
56.68,12363,5822,6541,218,Anklam,53.8560526,13.688091
62.59,12361,6131,6230,197,Gaildorf,49.0002603,9.7698525
67.54,12344,6135,6209,183,Hagenow,53.4305796,11.1904828
131.11,12296,6018,6278,94,Bad Freienwalde (Oder),52.787521,14.0300689
34.69,12278,6177,6101,354,Maxhütte-Haidhof,49.1987299,12.0959905
75.16,12272,6014,6258,163,Dinkelsbühl,49.0691672,10.3194022
123.3,12263,6099,6164,99,Burladingen,48.2892852,9.1134689
111.16,12237,6116,6121,110,Osterhofen,48.7019635,13.0201434
145.29,12186,6006,6180,84,Frohburg,51.0567105,12.5576743
64.02,12119,6014,6105,189,Bad Fallingbostel,52.8654484,9.6930195
32.44,12109,5993,6116,373,Miesbach,47.790025,11.8335417
61.73,12092,5964,6128,196,Wolgast,54.0536473,13.7757809
23.18,12082,5959,6123,521,Steinheim an der Murr,48.9652015,9.2789021
138.69,12026,5891,6135,87,Perleberg,53.075548,11.8212016
16.53,12008,5695,6313,726,Erkner,52.4259804,13.7542811
9.56,11999,5974,6025,1255,Lauenburg/ Elbe,53.3789803,10.5513889
33.57,11956,5885,6071,356,Oberderdingen,49.0626654,8.8021324
83.12,11929,5753,6176,144,Neustadt in Sachsen,51.0249519,14.2140882
94.6,11895,5867,6028,126,Monschau,50.5544687,6.2407954
12.85,11884,5799,6085,925,Hemsbach,49.5919545,8.6460261
22.63,11863,5901,5962,524,Lauffen am Neckar,49.0760664,9.150709
24.43,11858,5699,6159,485,Pößneck,50.694735,11.5953247
54.1,11835,5866,5969,219,Neuenrade,51.2831254,7.7830374
36.26,11801,5774,6027,325,Bad Dürrenberg,51.2998551,12.0665175
91.36,11790,5892,5898,129,Billerbeck,51.9773625,7.290923
54.38,11782,5669,6113,217,Wolmirstedt,52.2484924,11.6267388
40.34,11776,5779,5997,292,Geisenheim,49.9863945,7.96852
82.79,11775,5816,5959,142,Hauzenberg,48.6551971,13.6276784
23.47,11772,5833,5939,502,Leingarten,49.1434266,9.1240565
59.51,11769,5733,6036,198,Oestrich-Winkel,50.0071863,8.0167585
67.11,11766,5956,5810,175,Drolshagen,51.0237206,7.7770856
105.91,11760,5978,5782,111,Walldürn,49.5833,9.36667
11.84,11741,5802,5939,992,Lindenberg i.Allgäu,47.6015605,9.8863905
167.32,11736,5770,5966,70,Pritzwalk,53.1492896,12.1761903
88.3,11729,6129,5600,133,Geisenfeld,48.683404,11.6124731
49.49,11726,5910,5816,237,Schwaigern,49.1414205,9.0571085
35.7,11724,5872,5852,328,Marktheidenfeld,49.8444065,9.6003865
64.24,11702,5656,6046,182,Zwönitz,50.6301029,12.8131994
76.96,11696,5771,5925,152,Bopfingen,48.8577633,10.3523096
72.89,11682,5799,5883,160,Hildburghausen,50.4266327,10.7300263
23.22,11629,5618,6011,501,Bad Nenndorf,52.3360719,9.3769596
40.27,11602,5723,5879,288,Bad Schwalbach,50.141688,8.071992
296.82,11468,5755,5713,39,Coswig (Anhalt),51.8803541,12.458638
51.55,11463,5613,5850,222,Trostberg,48.0321101,12.5654359
44.39,11445,5770,5675,258,Lauingen (Donau),48.5710836,10.4305438
63.57,11434,5708,5726,180,Ochsenfurt,49.6643552,10.0647551
70.56,11431,5701,5730,162,Engen,47.8532383,8.7704457
20.45,11421,5471,5950,558,Ebersbach-Neugersdorf,51.0007273,14.5986609
12.41,11388,5923,5465,918,Diez,50.3694175,8.0174521
225.83,11388,5715,5673,50,Wittingen,52.7289399,10.735743
41.67,11385,5476,5909,273,Rothenburg ob der Tauber,49.3772526,10.1790017
159.92,11380,5510,5870,71,Gräfenhainichen,51.7309112,12.4588675
37.99,11378,5553,5825,299,Welzheim,48.8749241,9.6347406
73.5,11365,5730,5635,155,Rheinau,48.6610699,7.9383334
16.42,11321,5583,5738,689,Mülheim-Kärlich,50.3868869,7.4975336
64.96,11271,5814,5457,174,Riedlingen,48.1534412,9.4748796
42.8,11260,5672,5588,263,Isselburg,51.8344194,6.4614134
35.48,11242,5668,5574,317,Herbolzheim,48.2198805,7.7769882
80.01,11221,5560,5661,140,Waldkirchen,48.7300239,13.6015841
236.09,11216,5456,5760,48,Bad Belzig,52.1405622,12.5865873
24.67,11196,5441,5755,454,Eisenberg,50.9691346,11.8961116
16.22,11194,5531,5663,690,Rutesheim,48.8081226,8.9453257
35.42,11193,5498,5695,316,Werther (Westf.),52.0855997,8.4279437
47.28,11167,5374,5793,236,Braunfels,50.5017248,8.4012818
35.47,11167,5434,5733,315,Schöningen,52.1388507,10.9671073
74.81,11108,5535,5573,148,Balve,51.3326498,7.8670563
76.8,11086,5679,5407,144,Meßstetten,48.180597,8.961909
36.93,11071,5489,5582,300,Kenzingen,48.1918267,7.7689368
158.15,11049,5699,5350,70,Rüthen,51.4911392,8.4330329
76.44,11044,5518,5526,144,Haigerloch,48.3675198,8.7985138
38.99,11033,5272,5761,283,Stollberg/Erzgeb.,50.7087734,12.7762607
34.28,11032,5550,5482,322,Lorch,48.7982424,9.6898657
39.82,11031,5535,5496,277,Donzdorf,48.6856725,9.8107595
65.14,11009,5489,5520,169,Regen,49.1844212,12.4251773
40.11,11006,5482,5524,274,Gernsheim,49.7466,8.5112
9.11,10994,5429,5565,1207,Wildau,52.3214429,13.6348744
22.75,10987,5437,5550,483,Glückstadt,53.787927,9.4238157
61.9,10984,5308,5676,177,Gengenbach,48.4035425,8.0153059
53.19,10983,5598,5385,206,Altensteig,48.5851784,8.6014741
192.57,10940,5629,5311,57,Lichtenau,49.2805135,10.6836351
46.33,10924,5291,5633,236,Langenzenn,49.4950727,10.7937902
26.28,10883,5282,5601,414,Oelsnitz/Erzgeb.,50.7144724,12.7048401
88.39,10882,5380,5502,123,Gronau (Leine),52.0843618,9.7754675
47.42,10881,5388,5493,229,Boizenburg/ Elbe,53.375079,10.7232364
4.4,10869,5249,5620,2470,Steinbach (Taunus),50.1672827,8.572208
15.47,10853,5200,5653,702,Lichtenstein/Sa.,50.7556404,12.6345621
128.88,10826,5354,5472,84,Hammelburg,50.1152207,9.8904404
107.47,10789,5406,5383,100,Dingelstädt,51.3157508,10.3209989
213.11,10768,5459,5309,51,Osterwieck,51.9689672,10.7135463
47.75,10759,5164,5595,225,Bad Orb,50.2267544,9.3478635
31.9,10730,5431,5299,336,Dissen am Teutoburger Wald,52.115769,8.2034345
26.7,10708,5307,5401,401,Endingen am Kaiserstuhl,48.1412922,7.6999031
17.17,10683,5223,5460,622,Barmstedt,53.7889203,9.7703927
83.32,10658,5300,5358,128,Felsberg,51.1502197,9.451222
99.51,10651,5184,5467,107,Bad Staffelstein,50.1028339,10.999159
31.37,10650,5345,5305,339,Neuenhaus,52.5,6.96667
46.21,10648,5085,5563,230,Bischofswerda,51.1277815,14.1795516
25.92,10628,5386,5242,410,Burgau,48.4312893,10.4065009
105.22,10601,5202,5399,101,Bad Wildbad,48.7502439,8.550301
63.81,10588,5421,5167,166,Werlte,52.8518701,7.6764179
36.47,10574,5087,5487,290,Bad Iburg,52.1543708,8.0448115
47.33,10521,5166,5355,222,Simbach a.Inn,48.2663113,13.0279972
297.07,10516,5245,5271,35,Tangerhütte,52.4342158,11.8061052
21.39,10509,5183,5326,491,Lollar,50.6696,8.694
6.48,10470,4993,5477,1616,Büdelsdorf,54.3164345,9.6710695
161.36,10464,5086,5378,65,Gommern,52.0739555,11.8307231
125.59,10449,5158,5291,83,Schleusingen,50.5416758,10.7669624
27.76,10426,5006,5420,376,Flöha,50.8503529,13.0772325
52.33,10422,5245,5177,199,Aulendorf,47.9528162,9.6409331
74.64,10413,5229,5184,140,Braunsbedra,51.2840933,11.8855493
25.88,10402,5079,5323,402,Burgstädt,50.9199843,12.8056571
9.56,10401,5145,5256,1088,Betzdorf,50.7879961,7.8723802
52.38,10398,5035,5363,199,Grevesmühlen,53.8644705,11.1898839
65.04,10397,5070,5327,160,Nideggen,50.6913559,6.482614
26.51,10397,5207,5190,392,Weilheim an der Teck,48.6153949,9.5383156
11.22,10393,5045,5348,926,Nieder-Olm,49.9094108,8.2033406
104.86,10381,5158,5223,99,Steinau an der Straße,50.3556,9.4227
122.74,10377,5203,5174,85,Nossen,51.1542557,13.314546
56.68,10372,5271,5101,183,Wildberg,53.6530029,13.1232854
12.79,10366,5130,5236,810,Süßen,48.6826604,9.7586073
41.17,10350,5213,5137,251,Neuenstadt am Kocher,49.2361584,9.3293362
16.31,10335,5173,5162,634,Erlenbach a.Main,49.8046171,9.1594708
49.74,10333,5149,5184,208,Bogen,48.9082826,12.7185426
98.72,10329,5194,5135,105,Blumberg,47.8401424,8.534081
125.34,10307,5079,5228,82,Olbernhau,50.6564031,13.345242
82.06,10293,4866,5427,125,Demmin,53.9070019,13.0327836
100.02,10282,5230,5052,103,Beilngries,49.0351602,11.473829
41.56,10258,4948,5310,247,Bad Lauterberg im Harz,51.6313633,10.4706667
156.38,10253,4955,5298,66,Querfurt,51.378707,11.5974078
90.45,10228,4895,5333,113,Tangermünde,52.5431104,11.9722524
68.78,10200,4958,5242,148,Münchberg,50.1911369,11.7913908
99.97,10188,5152,5036,102,Rehburg-Loccum,52.4690166,9.1567507
51.41,10180,5070,5110,198,Rüdesheim am Rhein,49.9789358,7.92339
30.63,10159,4900,5259,332,Niebüll,54.7869088,8.8255846
108.17,10151,5095,5056,94,Bleicherode,51.4400566,10.5727462
165.61,10129,5069,5060,61,Oberzent,49.5509448,8.9860959
25.78,10105,4968,5137,392,Heubach,48.7888674,9.9345819
99.13,10084,5122,4962,102,Mittenwalde,52.2642238,13.5360563
53.66,10079,4866,5213,188,Meuselwitz,51.0475,12.2975
49.81,10077,5070,5007,202,Mengen,48.0498964,9.3321246
40.25,10059,4969,5090,250,Niddatal,50.2833,8.83333
46.49,10059,5005,5054,216,Gudensberg,51.1879395,9.3673288
133.56,10053,5108,4945,75,Schotten,50.48726,9.16192
56.86,10051,5321,4730,177,Neustadt (Hessen),50.8811,9.0897
15.75,10050,4866,5184,638,Wahlstedt,53.9528957,10.2121481
91.06,10042,4961,5081,110,Bad Frankenhausen/Kyffhäuser,51.3560142,11.1005235
23.6,10031,5042,4989,425,Aichtal,48.6278878,9.2412617
75.06,10012,5008,5004,133,Gemünden a.Main,50.056483,9.68987
15.41,10002,4854,5148,649,Bad Ems,50.3352062,7.7128538
142.06,9987,5009,4978,70,Schlitz,50.6866279,9.5464764
39.69,9983,4834,5149,252,Oldenburg in Holstein,54.2922574,10.8809805
48.37,9983,4600,5383,206,Bad Bevensen,53.0809408,10.5744812
126.36,9964,5049,4915,79,Trebbin,52.2150361,13.2140282
8.99,9887,4799,5088,1100,Friedrichsthal,51.4984727,10.5888582
53.66,9873,4814,5059,184,Oelsnitz/Vogtl.,50.4118935,12.1568975
46.73,9857,4763,5094,211,Bad König,49.7435067,9.0262376
18.62,9833,4856,4977,528,Osthofen,49.7053458,8.32494
78.64,9833,4832,5001,125,Fürstenau,52.5167872,7.6749583
62.23,9832,4891,4941,158,Heilsbronn,49.3378853,10.7887166
33.78,9829,4838,4991,291,Bad Liebenzell,48.7712716,8.7321279
106.6,9799,4828,4971,92,Altlandsberg,52.5936006,13.7760013
109.95,9785,4988,4797,89,Bockenem,52.0111484,10.1331159
55.21,9785,4656,5129,177,Pasewalk,53.5053677,13.9889049
97.01,9775,4792,4983,101,Laubach,50.0557179,7.5099389
113.24,9754,4928,4826,86,Dassel,51.8019566,9.6899606
159.2,9747,4780,4967,61,Visselhövede,52.9849747,9.5777771
127.66,9706,4795,4911,76,Wettin-Löbejün,51.6013305,11.8410521
122.34,9700,5008,4692,79,Hemau,49.0517528,11.7825077
140.65,9692,4634,5058,69,Bleckede,53.2933058,10.7299955
34.89,9689,4792,4897,278,Brandis,51.3346604,12.6089036
271.73,9676,4787,4889,36,Oberharz am Brocken,51.7035919,10.786511
40.95,9672,4765,4907,236,Großröhrsdorf,51.1456848,14.0199103
279.53,9666,4779,4887,35,Klötze,52.6276465,11.165058
19.93,9655,4722,4933,484,Bad Breisig,50.5098164,7.2983807
50.51,9649,4535,5114,191,Grimmen,54.1127844,13.0429152
51.88,9625,4805,4820,186,Wertingen,48.5619632,10.682637
60.25,9622,4695,4927,160,Miltenberg,49.7017584,9.2559718
89.46,9588,4621,4967,107,Lüchow (Wendland),52.9548952,11.0879277
207.44,9585,4794,4791,46,Luckau,51.8524163,13.7150055
13.65,9560,4705,4855,700,Töging a.Inn,48.2547192,12.5864967
88.24,9537,4667,4870,108,Sebnitz,50.97098,14.2727203
90.85,9519,4623,4896,105,Bad Gandersheim,51.8704732,10.0297839
43.71,9518,4761,4757,218,Runkel,50.42497,8.16703
98.73,9506,4772,4734,96,Nittenau,49.1980429,12.2718828
180.72,9491,4669,4822,53,Storkow (Mark),52.2058093,13.9049798
46.3,9479,4666,4813,205,Zwenkau,51.2182735,12.324152
113.6,9476,4703,4773,83,Ohrdruf,50.8270085,10.7319499
77.13,9472,4693,4779,123,Rain,48.6901192,10.9153669
12.65,9461,4465,4996,748,Wilkau-Haßlau,50.6750523,12.5115613
117.02,9441,4732,4709,81,Werneuchen,52.6460566,13.7411177
15.88,9439,4589,4850,594,Höhr-Grenzhausen,50.438904,7.6703879
63.08,9435,4646,4789,150,Ilsenburg (Harz),51.8667349,10.6831785
231.14,9421,4529,4892,41,Osterburg (Altmark),52.7899044,11.7526038
32.45,9407,4730,4677,290,Obernkirchen,52.270117,9.1286948
34.27,9403,4788,4615,274,Ichenhausen,48.3712746,10.3071082
26.69,9400,4600,4800,352,Kandel,49.0809754,8.1970699
70.49,9398,4640,4758,133,Tecklenburg,52.2217481,7.8169251
75.69,9395,4560,4835,124,Hohenmölsen,51.1573976,12.0981844
18.32,9373,4489,4884,512,Heiligenhafen,54.3717445,10.9809235
80.33,9366,4587,4779,117,Rehau,50.2500051,12.0332893
80.56,9345,4818,4527,116,Freystadt,49.1989574,11.3285933
13.22,9313,4465,4848,704,Vallendar,50.4001381,7.6142479
3.99,9306,4788,4518,2332,Weißenthurm,50.4145192,7.4557539
18.75,9305,4645,4660,496,Eisenberg (Pfalz),49.5589556,8.0732258
59.96,9301,4767,4534,155,Ochsenhausen,48.0711222,9.9512104
88.64,9298,4590,4708,105,Lügde,51.9088111,9.2715714
54.88,9294,4562,4732,169,Wunsiedel,50.0373241,12.0027278
70.13,9279,4586,4693,132,Bad Griesbach i.Rottal,48.4513352,13.1931047
237.09,9279,4587,4692,39,Kemberg,51.7735933,12.6358905
55.01,9277,4714,4563,169,Bad Schussenried,48.0047363,9.6561098
76.73,9273,4571,4702,121,Steinbach-Hallenberg,50.7006077,10.5674742
72.19,9269,4552,4717,128,Torgelow,53.6304232,14.0113284
138.88,9253,4513,4740,67,Bad Liebenwerda,51.5158115,13.39272
55.99,9252,4613,4639,165,Borgholzhausen,52.1007247,8.3023897
47.81,9252,4605,4647,194,Elze,52.1190302,9.7369863
41.71,9214,4765,4449,221,Waldheim,51.0770643,13.0157798
115.19,9187,4671,4516,80,Elsfleth,53.2357029,8.4571037
23.57,9182,4526,4656,390,Laufenburg (Baden),47.5671976,8.0599414
47.41,9169,4340,4829,193,Sassnitz,54.516728,13.644119
53.82,9144,4395,4749,170,Niesky,51.2921267,14.8250955
78.26,9127,4515,4612,117,Auerbach i.d.OPf.,49.6923981,11.6325698
59.09,9120,4514,4606,154,Breckerfeld,51.2603083,7.4667789
157.38,9114,4422,4692,58,Kyritz,52.9430648,12.3966896
23.75,9108,4472,4636,383,Mendig,50.3720933,7.2812427
114.31,9086,4477,4609,79,Zörbig,51.6291126,12.1175042
131.18,9063,4592,4471,69,Berching,49.1063443,11.4404282
36.6,9062,4532,4530,248,Neuötting,48.2405753,12.686742
149.34,9044,4478,4566,61,Zahna-Elster,51.8814693,12.8126754
82.57,9030,4599,4431,109,Furtwangen im Schwarzwald,48.0512198,8.2073776
17.37,9023,4446,4577,519,Reinfeld (Holstein),53.8300555,10.4869517
45.07,9007,4405,4602,200,Hemmoor,53.6886857,9.1595122
67.07,8998,4558,4440,134,Furth im Wald,49.3081639,12.8452826
85.57,8995,4454,4541,105,Bad Lauchstädt,51.3874297,11.8679537
22.79,8980,4280,4700,394,Zschopau,50.7469606,13.0695613
41.16,8978,4381,4597,218,Zwiesel,49.0130274,13.2307617
86.06,8971,4349,4622,104,Neustadt an der Orla,50.7364311,11.7458512
104.53,8956,4479,4477,86,Wetter (Hessen),50.91876,8.733367
35.98,8919,4188,4731,248,Plön,54.158082,10.41771
45.17,8918,4539,4379,197,Vohburg a.d.Donau,48.7703668,11.6183922
46.33,8908,4373,4535,192,Brand-Erbisdorf,50.8705512,13.3247933
39.6,8902,4370,4532,225,Florstadt,50.3173479,8.8653526
14.6,8888,4391,4497,609,Hallstadt,49.928801,10.8754637
24.82,8884,4393,4491,358,Obernburg a.Main,49.842229,9.1480461
54.7,8872,4393,4479,162,Ortenberg,50.35836,9.08399
42.54,8844,4338,4506,208,Bersenbrück,52.5553293,7.9471842
108.22,8815,4488,4327,81,Neuhaus am Rennweg,50.5105578,11.1407613
39.71,8811,4294,4517,222,Naunhof,51.2779508,12.5882898
22.7,8796,4332,4464,387,Waldenbuch,48.6374291,9.1312415
60.19,8789,4430,4359,146,Volkach,49.8656925,10.2261848
108.21,8788,4459,4329,81,Schleiz,50.5590505,11.8040013
10.71,8786,4193,4593,820,Bad Bergzabern,49.1028075,7.9991268
97.83,8782,4268,4514,90,Raguhn-Jeßnitz,51.7017806,12.3124486
11.12,8727,4322,4405,785,Rauenberg,49.2672457,8.7036146
76.22,8725,4417,4308,114,Meßkirch,47.9939249,9.1122006
49.6,8713,4472,4241,176,Möckmühl,49.3233013,9.3611411
43.33,8683,4177,4506,200,Kappeln,54.6641769,9.9317595
87.3,8682,4213,4469,99,Ballenstedt,51.722527,11.2290268
41.18,8681,4127,4554,211,Barth,54.3690547,12.7258585
149.01,8678,4198,4480,58,Herzberg (Elster),51.6924078,13.2358585
138.94,8673,4537,4136,62,Borgentreich,51.5702348,9.2362761
34.88,8648,4276,4372,248,Wissen,50.7829232,7.7344766
85.87,8638,4175,4463,101,Ueckermünde,53.7371069,14.0458887
19.34,8631,4234,4397,446,Nierstein,49.8710847,8.3365369
28.58,8630,4283,4347,302,Staufenberg,51.3496679,9.6344036
90.11,8616,4368,4248,96,Rottenburg a.d.Laaber,48.7001539,12.0282878
25.51,8591,4258,4333,337,Großbottwar,49.0013098,9.2929977
103.95,8580,4162,4418,83,Tirschenreuth,49.8780234,12.3372095
28.15,8566,4310,4256,304,Neuenbürg,48.8464524,8.5886312
23.32,8553,4045,4508,367,Staufen im Breisgau,47.883211,7.7329262
16.75,8553,4254,4299,511,Wörrstadt,49.8388822,8.1168059
62.47,8544,4283,4261,137,Viechtach,49.0800743,12.8862723
150.36,8536,4357,4179,57,Doberlug-Kirchhain,51.6219804,13.5660433
18.08,8534,4204,4330,472,Kuppenheim,48.8272323,8.2545743
7.49,8527,4411,4116,1138,Hermsdorf,50.897952,11.8567132
16.53,8523,4118,4405,516,Kirn,49.7861037,7.4584035
59.46,8522,4231,4291,143,Barntrup,51.9909552,9.1127565
47.07,8459,4150,4309,180,Teterow,53.7709505,12.5753569
62.26,8456,4127,4329,136,Kandern,47.714697,7.6610865
20.13,8447,4154,4293,420,Bönnigheim,49.0417185,9.0933985
84.07,8447,4146,4301,100,Colditz,51.1295496,12.8065842
39.76,8443,4164,4279,212,Kirchen (Sieg),50.8081255,7.87987
51.74,8441,4165,4276,163,Hainichen,50.996259,11.6223953
99.03,8431,4238,4193,85,Mücheln (Geiseltal),51.3015933,11.8039044
110.14,8431,4363,4068,77,Neunburg vorm Wald,49.3487545,12.3819759
96.93,8422,4180,4242,87,Lützen,51.2585623,12.1459521
120.26,8408,4167,4241,70,Stadtilm,50.774134,11.0805466
58.72,8372,4130,4242,143,Helmbrechts,50.2349797,11.7163126
73.75,8370,4170,4200,113,Bad Sooden-Allendorf,51.2695391,9.9719975
63.36,8340,4118,4222,132,Penig,50.9331827,12.7075852
30.28,8339,4044,4295,275,Lauter-Bernsbach,50.5614644,12.728134
81.66,8325,4183,4142,102,Herrieden,49.2360696,10.4979141
76.62,8316,4122,4194,109,Dannenberg (Elbe),53.0989099,11.0960722
18.81,8313,4128,4185,442,Kellinghusen,53.949549,9.7188996
144.61,8309,4185,4124,57,Mansfeld,51.5929057,11.4529104
46.27,8307,4038,4269,180,Premnitz,52.528092,12.3394514
15.34,8305,4009,4296,541,Landstuhl,49.4143311,7.5722301
81.86,8298,4049,4249,101,Großräschen/Rań,51.5883265,14.0123136
128.41,8297,4216,4081,65,Willebadessen,51.6257785,9.034262
36.41,8295,4074,4221,228,Zell am Harmersbach,48.3482133,8.0653343
33.01,8284,4068,4216,251,Bad Herrenalb,48.7990507,8.4382557
24.2,8282,4092,4190,342,Dornstetten,48.4663553,8.5012993
60.04,8276,4098,4178,138,Schieder-Schwalenberg,51.8980505,9.1751832
77.9,8272,3945,4327,106,Beeskow,52.1721569,14.2471058
112.1,8272,4162,4110,74,Arnstein,49.9783393,9.9684962
63.73,8229,3995,4234,129,Grafenau,48.8576397,13.3938284
49.02,8220,4047,4173,168,Daun,50.1962461,6.8305031
26.33,8208,4040,4168,312,Knittlingen,49.0239269,8.7579461
70.02,8207,3998,4209,117,Bad Lausick,51.144234,12.6415822
39.85,8191,4173,4018,206,Bützow,53.8500047,11.9832952
78.09,8177,4052,4125,105,Leisnig,51.16005,12.9265979
43.01,8167,4021,4146,190,Ramstein-Miesenbach,49.4518819,7.5543118
94.1,8161,4038,4123,87,Bad Sulza,51.0879382,11.6234198
11.96,8155,3891,4264,682,Simmern/ Hunsrück,49.9834956,7.5260197
125.78,8115,4095,4020,65,Könnern,51.6706514,11.7713656
126.05,8108,4089,4019,64,Medebach,51.1974918,8.7044753
12.15,8108,3943,4165,667,Ransbach-Baumbach,50.4667,7.73333
36.8,8106,3977,4129,220,Weida,50.7581426,12.0470063
16.17,8084,3738,4346,500,Kühlungsborn,54.1483764,11.7441876
57.25,8078,3947,4131,141,Calbe (Saale),51.9034006,11.7761208
11.81,8074,4040,4034,684,Baiersdorf,49.6568679,11.0311232
58.53,8071,4007,4064,138,Hüfingen,47.9269484,8.4892187
26.36,8067,3888,4179,306,Kirchheimbolanden,49.6644306,8.0107385
116.07,8065,4135,3930,69,Oranienbaum-Wörlitz,51.8243086,12.4136942
23.55,8055,4045,4010,342,Oberkochen,48.7840324,10.1060512
161.23,8053,3952,4101,50,Bad Schmiedeberg,51.6883775,12.7409236
42.14,8053,3939,4114,191,Lauta,51.4550406,14.0950367
118.51,8049,4121,3928,68,Neresheim,48.7539485,10.3343747
54.06,8026,4047,3979,148,Gundelfingen a.d.Donau,48.5534351,10.3678266
154.04,8023,4002,4021,52,Barby,51.9666473,11.8860511
31.08,8013,3850,4163,258,Schweich,49.8224303,6.7515418
39.56,7979,3878,4101,202,Kirchberg,49.9431629,7.4083878
328.14,7971,3924,4047,24,Rheinsberg,53.0983176,12.8910116
81.67,7968,3988,3980,98,Teuchern,51.1185488,12.0223935
38.23,7938,3948,3990,208,Teublitz,49.2211907,12.085254
290.7,7899,3952,3947,27,Bismark (Altmark),52.6611978,11.5546495
145.9,7893,4015,3878,54,Altenberg,50.766598,13.7523234
80.93,7881,3931,3950,97,Weikersheim,49.4806464,9.8976782
64.43,7860,3907,3953,122,Gerolstein,50.2234404,6.6618586
45.8,7859,3690,4169,172,Bad Düben,51.5911653,12.5856428
40.5,7847,3838,4009,194,Elsterwerda,51.4614993,13.5204883
30.49,7794,3836,3958,256,Lößnitz,50.6210947,12.730753
88.02,7787,3928,3859,88,Löffingen,47.8839004,8.3446627
22.29,7771,3770,4001,349,Lugau/Erzgeb.,50.7579779,12.7520515
209.54,7745,3814,3931,37,Kremmen,52.7604941,13.0294822
77.33,7706,3798,3908,100,Oederan,50.8614612,13.1694372
48.81,7697,3720,3977,158,Bad Liebenstein,50.8183801,10.3491578
163.49,7695,3791,3904,47,Calau/Kalawa,51.7466674,13.949307
43.74,7679,3745,3934,176,Treuen,50.5389413,12.3069937
50.44,7669,3701,3968,152,Klingenthal,50.3581046,12.4678923
57.32,7667,3916,3751,134,Parsberg,49.1598787,11.7187658
32.16,7661,3982,3679,238,Leipheim,48.4487175,10.2213539
31.06,7654,3629,4025,246,Falkenstein/Vogtl.,50.4773298,12.3691588
111.28,7653,3887,3766,69,Sontra,51.0831196,9.9542845
79.06,7651,3806,3845,97,Seeland,51.8113675,11.3321165
111.42,7645,3778,3867,69,Vetschau/Spreewald / Wětošow/Błota,51.7826993,14.0747958
84.03,7644,3756,3888,91,Hardegsen,51.6528043,9.8322034
74.91,7637,3783,3854,102,Vohenstrauß,49.6238348,12.341436
37.04,7618,3704,3914,206,Naila,50.3296301,11.7084131
54.02,7614,3779,3835,141,Radeburg,51.2149248,13.7241174
20.63,7612,3698,3914,369,Saarburg,49.6082527,6.548746
44.76,7605,4272,3333,170,Horstmar,52.0811414,7.3034425
75.28,7601,3771,3830,101,Elzach,48.1757263,8.0718474
19.38,7575,3714,3861,391,Bad Wimpfen,49.2303439,9.1621599
30.76,7556,3763,3793,246,Breuberg,49.8237774,9.0297787
93.11,7556,3813,3743,81,Münnerstadt,50.2490439,10.1942632
33.55,7555,3553,4002,225,Otterndorf,53.808132,8.899715
150.47,7550,3787,3763,50,Allstedt,51.402697,11.3873822
38.44,7550,3799,3751,196,Gundelsheim,49.2844,9.16194
70.17,7542,3598,3944,107,Groitzsch,51.15,12.2833
35.28,7541,3808,3733,214,Laufen,47.9354122,12.930309
7.1,7535,3651,3884,1061,Oppenheim,49.8527604,8.3548557
21.67,7517,3536,3981,347,Esens,53.6468107,7.6118499
30.89,7511,4100,3411,243,Hermeskeil,49.6554515,6.9481877
165.02,7510,3722,3788,46,Harzgerode,51.6381169,11.1465703
158.99,7495,3729,3766,47,Belgern-Schildau,51.4456448,12.9301967
62.15,7493,3702,3791,121,Bad Kötzting,49.169841,12.8782503
88.04,7485,3787,3698,85,Homberg (Ohm),50.7274933,8.997847
32.08,7451,3732,3719,232,Renchen,48.5873988,8.0143673
33.2,7428,3565,3863,224,Bad Sachsa,51.5963629,10.5534235
212.43,7422,3611,3811,35,Treuenbrietzen,52.0966552,12.8734896
55.32,7385,3562,3823,133,Bad Berka,50.9002644,11.2829778
95.01,7365,3775,3590,78,Ebern,50.0943461,10.7950972
83.43,7349,3654,3695,88,Pockau-Lengefeld,50.7190748,13.2256661
273.64,7348,3724,3624,27,Kalbe (Milde),52.6562002,11.3871751
86.52,7344,3666,3678,85,Eisfeld,50.4269984,10.908994
94.87,7344,3768,3576,77,Scheßlitz,49.9770848,11.0343944
21.26,7318,3518,3800,344,Meldorf,54.08988,9.070633
103.73,7309,3766,3543,70,Greding,49.045989,11.3525826
26.76,7301,3566,3735,273,Pulsnitz,51.1825771,14.0139733
44.11,7297,3651,3646,165,Roßwein,51.0838863,13.2112442
5.66,7284,3582,3702,1287,Zwingenberg,49.4191717,9.0405229
48.63,7263,3589,3674,149,Freyung,48.8099603,13.5491927
75.24,7250,3675,3575,96,Gedern,50.4051,9.2135
39.87,7249,3564,3685,182,Annweiler am Trifels,49.2027254,7.9682264
18.67,7241,3581,3660,388,Haslach im Kinzigtal,48.2769011,8.0871643
13.64,7236,3686,3550,530,Birkenfeld,49.6488236,7.1647477
109.28,7231,3554,3677,66,Malchin,53.7382631,12.7644198
60.95,7228,3648,3580,119,Dettelbach,49.8019103,10.1612139
59.99,7225,3535,3690,120,Aken (Elbe),51.85,12.05
73.08,7206,3526,3680,99,Roßleben-Wiehe,51.2914242,11.3965456
23.71,7205,3484,3721,304,Bernkastel-Kues,49.9157398,7.0708181
95.14,7200,3577,3623,76,Wriezen,52.7167845,14.1365723
28.54,7190,3552,3638,252,Immenhausen,51.4194918,9.5093272
12.77,7175,3514,3661,562,Nortorf,54.1684689,9.8559648
152.29,7135,3629,3506,47,Müncheberg,52.5037484,14.1404688
69.04,7132,3519,3613,103,Markneukirchen,50.311883,12.3292151
36.87,7116,3428,3688,193,Friedrichroda,50.8568766,10.567901
54.87,7115,3615,3500,130,Ilshofen,49.170072,9.9186069
103.01,7113,3525,3588,69,Königsee,50.6695507,11.1060743
99.68,7093,3612,3481,71,Geiselhöring,48.8258853,12.3926046
46.99,7084,3457,3627,151,Lengenfeld,50.5694023,12.3652544
37.45,7073,3477,3596,189,Höchstädt a.d.Donau,48.6114377,10.5670777
92.44,7070,3526,3544,76,Am Ettersberg,51.06552,11.2984194
13.99,7043,3437,3606,503,Gau-Algesheim,49.9580426,8.0130518
49.95,7041,3507,3534,141,Ebermannstadt,49.7802113,11.1875112
75.91,7017,3572,3445,92,Bonndorf im Schwarzwald,47.8190186,8.3415473
66.25,7014,3482,3532,106,Neukirchen,54.8687122,8.7339915
27.56,6997,3487,3510,254,Reichelsheim (Wetterau),50.3611717,8.8207006
61.2,6996,3492,3504,114,Heringen (Werra),50.8868593,9.9746798
112.24,6975,3400,3575,62,Eibenstock,50.4951715,12.5983957
94.05,6974,3480,3494,74,Neustadt-Glewe,53.393252,11.5753248
18.39,6966,3444,3522,379,Gerolzhofen,49.9009668,10.3494113
82.39,6956,3592,3364,84,Moringen,51.6982506,9.8691556
75.87,6952,3598,3354,92,Schelklingen,48.3755469,9.7341832
25.27,6931,3425,3506,274,Böhlen,51.2027284,12.3859676
28.68,6930,3468,3462,242,Polch,50.298748,7.3129547
18.75,6922,3460,3462,369,Dietenheim,48.2111094,10.0700937
64.7,6920,3455,3465,107,Vilseck,49.6124242,11.8070092
59.18,6878,3414,3464,116,Schwarzenbach a.d.Saale,50.2032507,11.9350537
17.89,6838,3451,3387,382,Edenkoben,49.282236,8.1284357
28.94,6834,3428,3406,236,Gröditz,51.4121605,13.4473168
67.47,6830,3440,3390,101,Volkmarsen,51.4230543,9.0971197
59.47,6807,3395,3412,114,Uffenheim,49.5440036,10.2343701
54.71,6797,3321,3476,124,Geithain,51.054325,12.694675
7.9,6795,3350,3445,860,Kahla,50.8025663,11.5877025
101.17,6781,3402,3379,67,Waldmünchen,49.3775728,12.7062127
115.7,6780,3378,3402,59,Waldeck,51.2425113,9.0381211
15.69,6768,3298,3470,431,Rodalben,49.2384912,7.6392258
93.65,6758,3305,3453,72,Ketzin/Havel,52.4769264,12.8443972
95.93,6735,3306,3429,70,Hecklingen,51.8485211,11.5345948
102.87,6730,3345,3385,65,Gerbstedt,51.6186924,11.6366979
47.86,6722,3390,3332,140,Neuenstein,49.2049886,9.5813213
101.71,6710,3442,3268,66,Boxberg,50.2731793,6.8751755
216.21,6710,3241,3469,31,Grafenwöhr,49.7209693,11.9018013
272.03,6708,3402,3306,25,Jerichow,52.4976362,12.0257528
54.4,6700,3319,3381,123,Hartha,51.0984539,12.9715576
25.4,6697,3386,3311,264,Maulbronn,48.9986948,8.8038083
47.32,6694,3421,3273,141,Osterburken,49.4305787,9.4273773
24.18,6684,3239,3445,276,Stadtroda,50.8582666,11.7263639
23.71,6674,3253,3421,281,Bad Brückenau,50.3101441,9.7912176
271.13,6666,3344,3322,25,Arendsee (Altmark),52.8808292,11.4922352
66.53,6666,3290,3376,100,Waldsassen,50.0053222,12.3041123
17.99,6661,3301,3360,370,Herdorf,50.7788397,7.9514498
39.38,6644,3263,3381,169,Mitterteich,49.9509605,12.2429771
77.65,6643,3294,3349,86,Bad Rodach,50.3411272,10.7785015
104.8,6638,3346,3292,63,Buttstädt,51.1213474,11.4168304
113.75,6609,3281,3328,58,Blankenhain,50.8604751,11.3418229
86.55,6609,3254,3355,76,Zierenberg,51.3869629,9.275937
45.41,6605,3474,3131,145,Rötha,51.1972196,12.417228
10.98,6603,3187,3416,601,Altenkirchen (Westerwald),50.6880109,7.6477412
51.11,6590,3338,3252,129,Rosenfeld,48.2880909,8.7233324
48.78,6590,3249,3341,135,Pegau,51.1667169,12.255453
95.64,6581,3347,3234,69,Glashütte,48.6310669,9.1536626
122.45,6571,3331,3240,54,Römhild,50.3927584,10.5678277
44.71,6558,3182,3376,147,Malchow,53.4775641,12.4245172
114.9,6555,3272,3283,57,Laage,53.9258806,12.3501625
45.05,6551,3225,3326,145,Artern,51.3627798,11.2935249
141.79,6550,3217,3333,46,Friedland,53.6716022,13.5487647
61.07,6543,3292,3251,107,Neumarkt-Sankt Veit,48.3607951,12.5083828
20.03,6526,3257,3269,326,Thannhausen,48.2829292,10.4682347
15.61,6525,3272,3253,418,Rodenberg,52.3129195,9.3584245
11.71,6495,3225,3270,555,Heitersheim,47.8736185,7.6580337
150.12,6494,3187,3307,43,Havelberg,52.8250425,12.0741929
54.18,6484,3185,3299,120,Bad Sobernheim,49.7843963,7.6520457
89.52,6465,3308,3157,72,Kölleda,51.1880844,11.2443392
40.6,6459,3167,3292,159,Burgkunstadt,50.1428821,11.2515508
53.57,6427,3246,3181,120,Wassertrüdingen,49.0406727,10.5969426
25.24,6422,3216,3206,254,Beilstein,49.0403804,9.3137915
80.08,6418,3225,3193,80,Wittenburg,53.505962,11.084783
17.98,6417,3098,3319,357,Linz am Rhein,50.5662481,7.2812557
226.59,6403,3187,3216,28,Annaburg,51.7327678,13.0434296
26.87,6396,3094,3302,238,Rodewisch,50.5308866,12.4047996
17.43,6396,3212,3184,367,Neuffen,48.5545979,9.376547
16.27,6391,3221,3170,393,Güglingen,49.0668087,8.9999838
39.68,6381,3058,3323,161,Glücksburg (Ostsee),54.8454448,9.5620334
62.36,6349,3166,3183,102,Nabburg,49.4543783,12.1806935
36.12,6336,3163,3173,175,Zell im Wiesental,47.7054471,7.8476208
73.75,6315,3194,3121,86,Geisingen,47.922968,8.6491814
21.13,6310,3128,3182,299,Klingenberg a.Main,49.7824102,9.1827765
79.2,6304,3189,3115,80,Trochtelfingen,48.307755,9.2448375
28.59,6303,3154,3149,220,Dohna,50.955232,13.8587012
52.97,6298,3208,3090,119,Gammertingen,48.2493445,9.2157336
9.95,6279,3108,3171,631,Bad Marienberg (Westerwald),50.650076,7.948217
59.86,6257,3095,3162,105,Bernsdorf,50.7667099,12.6666905
78.7,6257,3268,2989,80,Dietfurt a.d.Altmühl,49.0349586,11.5876537
77.67,6255,3171,3084,81,Werra-Suhl-Tal,50.9214071,10.0883617
122.33,6254,3128,3126,51,Arnstein,49.9783393,9.9684962
68.12,6248,3177,3071,92,Windsbach,49.2468793,10.8263669
64.56,6242,3227,3015,97,Alpirsbach,48.3456021,8.4033079
21.43,6236,2959,3277,291,Hachenburg,50.6627538,7.8253173
100.3,6230,3139,3091,62,Riedenburg,48.9717049,11.6927181
37.59,6226,3091,3135,166,Großalmerode,51.2440301,9.80537
44.91,6219,3098,3121,138,Dornhan,48.3502837,8.5078535
37.36,6218,3137,3081,166,Vogtsburg im Kaiserstuhl,48.0826236,7.6236716
97.71,6214,3202,3012,64,Spangenberg,51.1265161,9.7013806
82.16,6205,3064,3141,76,Falkenberg/Elster,51.5854858,13.2435457
79.71,6189,3232,2957,78,Nieheim,51.8039402,9.1112266
69.51,6176,3018,3158,89,Bad Königshofen i.Grabfeld,50.2834349,10.4796208
20.09,6173,3021,3152,307,Bad Hönningen,50.5157382,7.3065922
12.07,6168,2904,3264,511,Meersburg,47.6955538,9.2719656
116.27,6166,3020,3146,53,Plau am See,53.4600943,12.2631689
74.69,6146,2946,3200,82,Lübz,53.4623324,12.0293606
60.92,6120,3043,3077,100,Biesenthal,52.7664978,13.6289589
70.24,6087,3172,2915,87,Schlüsselfeld,49.7569182,10.6186266
62.14,6058,3055,3003,97,Bräunlingen,47.9300645,8.448329
14.37,6057,3222,2835,422,Kusel,49.5399844,7.4008479
28.92,6029,3055,2974,208,Haiterbach,48.5250249,8.6472766
31.98,6026,3021,3005,188,Dierdorf,50.5478886,7.6564407
121.68,6022,2944,3078,49,Gransee,53.0618234,13.166625
31.96,5993,2981,3012,188,Geislingen,48.2886289,8.8135495
35.62,5992,2990,3002,168,Bad Blankenburg,50.6829946,11.2726327
26.31,5990,2818,3172,228,Norderney,53.7056126,7.1438175
4.83,5979,2849,3130,1238,Marne,53.9521162,9.0107437
24.34,5978,3005,2973,246,Schirgiswalde-Kirschau,51.0860728,14.4320956
72.01,5970,3025,2945,83,Tittmoning,48.0621714,12.7676484
10.79,5961,2850,3111,552,Thalheim/Erzgeb.,50.7024268,12.8514034
95.29,5953,2991,2962,62,An der Schmücke,51.2932423,11.1803592
9.93,5950,2912,3038,599,Neustadt a.d.Waldnaab,49.7314121,12.1732938
105.21,5947,3084,2863,57,Schrozberg,49.3457515,9.9815378
31.63,5892,2886,3006,186,Münzenberg,50.4518351,8.7759774
79.57,5892,2958,2934,74,Nienburg (Saale),51.8371558,11.7675525
80.76,5882,2960,2922,73,Großbreitenbach,50.5806039,11.004454
18.48,5868,2851,3017,318,Westerburg,50.5622605,7.9693269
31.6,5860,2855,3005,185,Wemding,48.8745463,10.7240157
75.96,5855,3119,2736,77,Nottertal-Heilinger Höhen,51.2317899,10.6535225
28.66,5847,2898,2949,204,Leun,50.56045,8.32625
9.75,5826,2828,2998,598,Bredstedt,54.6236326,8.9640834
24.69,5815,2865,2950,236,Neubulach,48.6617473,8.6958614
74.13,5814,2895,2919,78,Herrnhut,51.0165447,14.7438435
14.68,5812,2821,2991,396,Oberlungwitz,50.7894372,12.7343596
55.08,5794,2890,2904,105,Mügeln,51.2335824,13.0181304
41.02,5768,2880,2888,141,Stavenhagen,53.6952808,12.9082954
36.07,5760,2866,2894,160,Hausach,48.2836305,8.174972
8.41,5759,2839,2920,685,Kastellaun,50.0713361,7.4422325
94.41,5748,2937,2811,61,Kaltennordheim,50.6262716,10.1582897
72.46,5744,2904,2840,79,Treffurt,51.1104119,10.2174474
213.85,5739,2799,2940,27,Fürstenberg/Havel,53.1852387,13.1456754
23.76,5716,2720,2996,241,Rochlitz,51.0456789,12.7990531
56.79,5714,2848,2866,101,Kemnath,49.8581156,11.9355154
24.92,5713,2830,2883,229,Stadtoldendorf,51.8842114,9.6252205
22.25,5713,2833,2880,257,Grünhain-Beierfeld,50.5689729,12.7955534
67.98,5712,2839,2873,84,Wolfach,48.2985845,8.222608
86.82,5711,2843,2868,66,Greußen,51.2283518,10.9481696
25.57,5708,2805,2903,223,Waibstadt,49.2978738,8.9205595
49.84,5706,2815,2891,114,Grebenstein,51.4557935,9.4262334
10.11,5703,2825,2878,564,Wirges,50.4700819,7.7956173
84.07,5689,2819,2870,68,Leutershausen,49.2992825,10.4117748
49.68,5687,2790,2897,114,Brotterode-Trusetal,50.7859635,10.4062727
30.61,5678,2877,2801,185,Niedenstein,51.2152682,9.3061335
42.73,5670,2711,2959,133,Seelow,52.5318238,14.380704
32.91,5668,2882,2786,172,Neudenau,49.2940857,9.2731888
74.96,5666,2775,2891,76,Hirschau,49.5445912,11.9464314
48.92,5663,2765,2898,116,Bad Lobenstein,50.449292,11.6380757
31.35,5662,2803,2859,181,Traben-Trarbach,49.9530436,7.1233159
73.16,5652,2855,2797,77,Harburg (Schwaben),48.787206,10.6889571
61.02,5648,2768,2880,93,Wittichenau / Kulow,51.3850743,14.2435979
39.74,5639,2774,2865,142,Schöppenstedt,52.1439998,10.7751941
33.44,5637,2772,2865,169,Schwarzheide,51.4858276,13.8306977
35.67,5631,2810,2821,158,Zeil a.Main,50.0137529,10.5948036
29.05,5618,2725,2893,193,Bodenwerder,51.9752481,9.5139063
48.41,5614,2777,2837,116,Abenberg,49.2419719,10.9638694
14.3,5608,3010,2598,392,Heimsheim,48.8058986,8.8619207
56.03,5599,2737,2862,100,Mellrichstadt,50.4282218,10.3020932
64.71,5585,2834,2751,86,Battenberg (Eder),51.0323524,8.6112782
72.27,5573,2756,2817,77,Grabow,53.2789153,11.5625238
22.86,5563,2811,2752,243,Prüm,50.2069481,6.4249003
175.66,5553,2828,2725,32,Velburg,49.2330244,11.6716022
15.86,5551,2747,2804,350,Hagenbach,49.0196679,8.247413
69.33,5544,2844,2700,80,Monheim,48.8423558,10.8562708
60.89,5540,2776,2764,91,Stolpen,51.0492329,14.0830003
40.81,5538,2791,2747,136,Eltmann,49.9725016,10.6662064
143.9,5534,2789,2745,38,Drebkau/Drjowk,51.6577353,14.2204983
89.34,5521,2737,2784,62,Gersfeld (Rhön),50.4497667,9.8943709
93.2,5518,2811,2707,59,Stühlingen,47.7470397,8.4474495
91.9,5518,2795,2723,60,Zarrentin am Schaalsee,53.5497556,10.9169686
88.72,5498,2744,2754,62,Bad Gottleuba-Berggießhübel,50.8584186,13.9480444
31.65,5495,2739,2756,174,Braunlage,51.7264388,10.6100516
46.48,5489,2745,2744,118,Ingelfingen,49.3014449,9.6513353
69.41,5488,2689,2799,79,Ellrich,51.587313,10.6649031
6.15,5479,2594,2885,891,Lütjenburg,54.2928257,10.5905485
71.23,5467,2731,2736,77,Tharandt,50.9853391,13.5794907
61.63,5465,2741,2724,89,Großschirma,50.9664763,13.2784375
47.76,5459,2649,2810,114,Gadebusch,53.70187,11.1177362
32.11,5438,2626,2812,169,Otterberg,49.5008961,7.7723649
13.07,5422,2688,2734,415,Munderkingen,48.2358225,9.6441788
81.43,5414,2794,2620,66,Külsheim,49.6696553,9.5207106
89.08,5413,2726,2687,61,Wasungen,50.6642615,10.367141
36.83,5395,2699,2696,146,Rockenhausen,49.6290332,7.8206451
16.59,5381,2675,2706,324,Mahlberg,48.2871478,7.8124221
21.09,5378,2625,2753,255,Lindenfels,49.7051422,8.7743264
82.55,5360,2686,2674,65,Diemelstadt,51.4813132,8.992125
34.22,5359,2684,2675,157,Oettingen i.Bay.,48.9529964,10.6039216
21.18,5346,2701,2645,252,Cochem,50.1483916,7.1663195
43.84,5313,2842,2471,121,Adelsheim,49.4053706,9.3903482
76.61,5306,2604,2702,69,Burg Stargard,53.4956816,13.3097058
38.09,5302,2717,2585,139,Forchtenberg,49.2889174,9.5608005
30.77,5298,2574,2724,172,Dornburg-Camburg,51.0446423,11.676008
13.03,5281,2562,2719,405,Waldmohr,49.3876652,7.3351606
55.67,5272,2670,2602,95,Spalt,49.1753302,10.9254208
51.48,5266,2609,2657,102,Pfreimd,49.4936077,12.1798657
38.55,5254,2588,2666,136,Ruhla,50.8941173,10.3814517
29.04,5243,2580,2663,181,Kitzscher,51.1645029,12.5529858
73.29,5225,2655,2570,71,Pottenstein,49.7721841,11.4087415
53.07,5213,2604,2609,98,Altentreptow,53.692909,13.2512212
56.34,5203,2606,2597,92,Hofheim i.UFr.,50.1567915,10.5498554
48.97,5193,2634,2559,106,Freren,52.4858972,7.5459254
52.24,5148,2615,2533,99,Wörth a.d.Donau,49.0012229,12.4041615
58.67,5126,2385,2741,87,Hitzacker (Elbe),53.1512116,11.0440938
64.87,5111,2558,2553,79,Creußen,49.8438482,11.6252782
104.11,5104,2594,2510,49,Falkenstein/Harz,51.7071447,11.3333212
19.13,5098,2540,2558,266,Ronneburg,50.8630523,12.1809073
66.32,5095,2529,2566,77,Naumburg,51.1525648,11.8099186
43.19,5094,2560,2534,118,Arzberg,50.0567356,12.1859087
135.61,5092,2584,2508,38,Uebigau-Wahrenbrück,51.5743703,13.3431138
67.56,5088,2529,2559,75,Erbendorf,49.837847,12.0481655
38.29,5061,2413,2648,132,Schwaan,53.9400696,12.1071145
27.62,5051,2505,2546,183,Lichtenau,49.2805135,10.6836351
8.16,5041,2440,2601,618,Unkel,50.5996127,7.2157397
30.98,5012,2407,2605,162,Borkum,53.5862669,6.6917449
30.68,5012,2390,2622,163,Röbel/Müritz,53.3768182,12.6059705
43.9,5000,2500,2500,114,Amöneburg,50.7975562,8.9231329
62.42,4985,2519,2466,80,Oberviechtach,49.4602721,12.4189759
36.37,4984,2500,2484,137,Windischeschenbach,49.8007569,12.1565859
69.75,4962,2484,2478,71,Todtnau,47.8303378,7.9452378
13.59,4954,2381,2573,365,Freinsheim,49.5066726,8.2108403
8.05,4951,2406,2545,615,Emmelshausen,50.1557618,7.5557802
45.12,4945,2544,2401,110,Scheinfeld,49.6653406,10.462567
44.43,4940,2444,2496,111,Tönning,54.3188928,8.9437049
33.33,4926,2543,2383,148,Triberg im Schwarzwald,48.1298016,8.232271
29.81,4925,2449,2476,165,Niederstotzingen,48.5408791,10.2332512
104.05,4922,2534,2388,47,Niederstetten,49.4003232,9.9189607
72.98,4914,2463,2451,67,Oppenau,48.4751652,8.1646682
64.36,4913,2499,2414,76,Marienmünster,51.8282084,9.2389221
18.9,4912,2406,2506,260,Thum,50.6698953,12.952226
40.87,4905,2471,2434,120,Lauchheim,48.8716385,10.2454589
44.41,4903,2427,2476,110,Vacha,50.8272621,10.0213868
80.66,4884,2425,2459,61,Hollfeld,49.9389862,11.2918916
62.03,4873,2428,2445,79,Tengen,47.8166011,8.6594228
162.57,4863,2383,2480,30,Dahme/Mark,51.8699392,13.4284903
78.06,4843,2406,2437,62,Iphofen,49.7042096,10.2607784
23.25,4834,2487,2347,208,Schömberg,48.211058,8.7604633
67.55,4816,2425,2391,71,Kröpelin,54.0720121,11.7936085
71.94,4807,2402,2405,67,Geisa,50.7144688,9.9498496
90.14,4803,2414,2389,53,Weismain,50.0850003,11.2400354
15.88,4791,2348,2443,302,Wörth a.Main,49.7955109,9.1574558
62.64,4789,2375,2414,76,Reichenbach/O.L.,51.1413085,14.8013577
88.22,4785,2320,2465,54,Eggesin,53.6820915,14.077945
69.37,4785,2380,2405,69,Trendelburg,51.5702326,9.3936842
18.27,4762,2383,2379,261,Groß-Bieberau,49.7902515,8.8161036
75.86,4760,2263,2497,63,Crivitz,53.5781613,11.6470654
17.04,4756,2218,2538,279,Wilthen,51.0952854,14.3946921
67.7,4756,2364,2392,70,Bischofsheim i.d.Rhön,50.4011137,10.0075314
31.89,4752,2385,2367,149,Vellberg,49.0864261,9.8812131
66.61,4745,2314,2431,71,Lommatzsch,51.1952586,13.3111561
69.23,4734,2264,2470,68,Müllrose,52.2468189,14.4181081
23.75,4710,2388,2322,198,Bad Buchau,48.0641747,9.6106661
42.97,4694,2288,2406,109,Adorf/Vogtl.,50.3206834,12.2535919
107.2,4693,2312,2381,44,Seehausen (Altmark),52.8888609,11.7519908
58.64,4688,2371,2317,80,Heideck,49.1326668,11.126046
17.55,4687,2333,2354,267,Nassau,50.3148917,7.8000899
64.13,4682,2307,2375,73,Pausa-Mühltroff,50.5670447,11.9601733
52.19,4674,2298,2376,90,Schönberg,53.6781808,10.4318363
140.52,4673,2393,2280,33,Marlow,54.1556493,12.5725117
78.48,4664,2284,2380,59,Königsbrück,51.2637467,13.9028337
35.13,4646,2261,2385,132,Eschenbach i.d.OPf.,49.7531092,11.8294634
52.9,4643,2432,2211,88,Krautheim,49.3861751,9.6346258
79.98,4625,2365,2260,58,Herbstein,50.5608868,9.3804574
120.16,4621,2465,2156,38,Lübtheen,53.3023864,11.0842837
67.32,4615,2303,2312,69,Rauschenberg,50.9089878,8.8864674
69.73,4602,2355,2247,66,Amt Creuzburg,51.0666037,10.2782817
66.91,4582,2336,2246,68,Heringen/Helme,51.4471763,10.8809101
46.69,4579,2250,2329,98,Freyburg (Unstrut),51.2126192,11.7696956
60.45,4579,2343,2236,76,Tann (Rhön),50.636953,10.0040118
40.93,4567,2453,2114,112,Kirchberg an der Jagst,49.2044838,9.9817296
117.23,4565,2349,2216,39,Creglingen,49.4688744,10.0298459
69.19,4538,2167,2371,66,Baumholder,49.6167,7.33333
24.97,4535,2214,2321,182,Wachenheim an der Weinstraße,49.4410363,8.1815115
40.76,4535,2232,2303,111,Dahn,49.1493317,7.7802569
38.26,4526,2279,2247,118,Bad Berneck i.Fichtelgebirge,50.0531177,11.686857
15.89,4521,2162,2359,285,Ehrenfriedersdorf,50.6442951,12.9675018
40.38,4520,2300,2220,112,Gerabronn,49.2498124,9.9229743
142.14,4500,2245,2255,32,Liebenwalde,52.866517,13.3902046
66.69,4492,2186,2306,67,Putbus,54.3535322,13.4749134
65.35,4488,2340,2148,69,Hallenberg,51.1096147,8.6201021
23.38,4482,2206,2276,192,Augustusburg,50.8144193,13.1009791
30.73,4467,2239,2228,145,Rabenau,50.9631279,13.6418236
36.7,4458,2191,2267,121,Hartenstein,49.5952202,11.5240797
13.49,4452,2131,2321,330,Peitz/Picnjo,51.8584667,14.4110395
13.05,4445,2158,2287,341,Nastätten,50.199081,7.858179
18.14,4426,2225,2201,244,Rennerod,50.606603,8.0662451
87.48,4399,2150,2249,50,Strasburg (Uckermark),53.5084448,13.7434101
2.71,4389,2166,2223,1620,Wilster,53.9233519,9.3741366
28.91,4381,2130,2251,152,Dransfeld,51.5012034,9.7583419
22.49,4376,2196,2180,195,Schönau,49.4366884,8.8090874
16.36,4366,2193,2173,267,Rheinböllen,50.0063415,7.6708226
8.08,4355,2048,2307,539,Wyk auf Föhr,54.6892888,8.5561518
64.96,4349,2176,2173,67,Heimbach,49.6141458,7.2481879
41.64,4318,2155,2163,104,Tambach-Dietharz/Thür. Wald,,
118.01,4318,2117,2201,37,Dargun,53.9,12.85
233.83,4314,2215,2099,18,Baruth/Mark,52.0462945,13.5019022
36.7,4301,2098,2203,117,Schwarzenbach a.Wald,50.2835975,11.6271654
72.41,4292,2179,2113,59,Rothenburg/O.L.,51.3333094,14.9666932
66.34,4287,2140,2147,65,Pressath,49.7698203,11.9343043
63.41,4277,2182,2095,67,Schnaittenbach,49.5478302,12.0007006
27.75,4274,2049,2225,154,Selbitz,50.3139673,11.7485834
54.45,4256,2135,2121,78,Hornberg,48.2128411,8.2316356
89.91,4254,2135,2119,47,Loitz,53.96913,13.1285573
86.19,4248,2139,2109,49,Brück,52.1923564,12.7584313
37.83,4248,2155,2093,112,Gräfenberg,49.6448945,11.2495348
50.32,4248,2036,2212,84,Gefrees,50.0958031,11.7402417
60.37,4233,2074,2159,70,Waldershof,49.9829487,12.0663612
19.58,4223,2083,2140,216,Daaden,50.7391746,7.96766
26.41,4213,2134,2079,160,Neckarbischofsheim,49.293192,8.9617359
17.69,4213,2154,2059,238,Niedernhall,49.2946494,9.6165589
46.88,4212,2077,2135,90,Wanfried,51.1714,10.1841616
164.17,4209,2080,2129,26,Woldegk,53.4592923,13.5833378
54.41,4207,2052,2155,77,St. Blasien,47.7602106,8.131426
71.87,4201,2085,2116,58,Dahlen,52.5622416,11.828413
96.53,4200,2096,2104,44,Waldkappel,51.1351872,9.8568782
18.05,4177,2075,2102,231,Kirchberg (Hunsrück),49.9330554,7.3547679
30.05,4166,2027,2139,139,Geringswalde,51.0760493,12.9048523
8.32,4131,2021,2110,497,Lambrecht (Pfalz),49.3693393,7.9772186
44.95,4117,2074,2043,92,Zell (Mosel),50.0275681,7.1813233
96.77,4114,2084,2030,43,Lichtenfels,50.14568,11.06382
22.05,4101,2092,2009,186,Allendorf (Lumda),50.6737,8.8177
17.24,4099,2092,2007,238,Neckarsteinach,49.4221,8.8396
32.14,4065,2033,2032,126,Baunach,49.9853262,10.8511236
115.56,4053,2014,2039,35,Penzlin,53.5055701,13.0843264
31.25,4045,1993,2052,129,Ellingen,49.0608124,10.9677438
28.34,4027,1987,2040,142,Lunzenau,50.968023,12.7216131
66.96,4021,2026,1995,60,Dassow,53.9089582,10.9756958
8.45,4020,1940,2080,476,Hoya,52.8065,9.13957
54.43,4019,2041,1978,74,Lorch,48.7982424,9.6898657
25.14,4019,1964,2055,160,Neubukow,54.0314438,11.6721265
24.51,4019,1973,2046,164,Tessin,54.0263099,12.4684089
27.51,3974,2011,1963,144,Neukloster,53.8645385,11.6824343
22.74,3967,1971,1996,174,Tegernsee,47.7099191,11.7543337
36.23,3962,1924,2038,109,Güsten,51.7947764,11.6078635
20.16,3961,2029,1932,196,Marktbreit,49.6668852,10.1435763
64.32,3951,1996,1955,61,Pappenheim,48.9347639,10.9744311
67.69,3943,1914,2029,58,Sternberg,53.7118374,11.8288314
72.53,3942,2001,1941,54,Seßlach,50.1876408,10.8429636
64.65,3941,2001,1940,61,Kindelbrück,51.2611366,11.089054
25.06,3923,1934,1989,157,Waldenburg,50.8743975,12.6003812
58.65,3915,1961,1954,67,Gemünden (Wohra),50.9934023,8.9675885
50.9,3914,1913,2001,77,Amorbach,49.643684,9.2225034
158.28,3871,1888,1983,24,Mirow,53.2851568,12.847677
26.37,3845,1922,1923,146,Regis-Breitingen,51.0889296,12.4396124
30.51,3821,1887,1934,125,Wolkenstein,50.6557148,13.0664608
15.36,3818,1910,1908,249,Speicher,49.9354628,6.6389817
26.54,3773,1803,1970,142,Deidesheim,49.4075922,8.1859168
35.05,3771,1888,1883,108,Trebsen/Mulde,51.2894732,12.7517578
29.59,3749,1850,1899,127,Johanngeorgenstadt,50.4310567,12.7146849
55.33,3746,1896,1850,68,Weißensee,51.1994358,11.068097
37.22,3737,1807,1930,100,Ruhland,51.4590647,13.8656245
30.27,3726,1787,1939,123,Strehla,51.370557,13.2397429
34.21,3725,1836,1889,109,Schiltach,48.2901774,8.3436346
12.51,3718,1811,1907,297,Netzschkau,50.6133033,12.2487152
70.47,3709,1902,1807,53,Vöhrenbach,48.0458156,8.3039184
34.76,3701,1857,1844,106,Freudenberg,49.7486131,9.3261061
25.1,3701,1784,1917,147,Elsterberg,50.6036333,12.176645
14.85,3701,1849,1852,249,Bad Karlshafen,51.6253296,9.4431158
44.72,3696,1863,1833,83,Grünsfeld,49.6082782,9.7447803
15.38,3685,1817,1868,240,Bad Muskau / Mužakow,51.5470046,14.7215146
20.34,3672,1783,1889,181,Bad Köstritz,50.9301118,12.0113701
44.59,3638,1799,1839,82,Rehna,53.7811418,11.0487109
33.15,3631,1822,1809,110,Triptis,50.7353974,11.8633794
19.77,3617,1718,1899,183,Bad Elster,50.2811665,12.236949
61.88,3614,1803,1811,58,Königsberg i.Bay.,50.0818105,10.570198
19.12,3610,1758,1852,189,Seifhennersdorf,50.9346533,14.6092022
26.35,3587,1767,1820,136,Steinach,48.9535682,12.6062471
21.74,3570,1761,1809,164,Mühlheim an der Donau,48.0248356,8.8894883
23.92,3568,1783,1785,149,Eschershausen,51.9270363,9.6383915
5.13,3545,1707,1838,691,Wesselburen,54.2123426,8.9217594
59.89,3525,1749,1776,59,Gröningen,51.9363717,11.2166312
30.68,3523,1725,1798,115,Goldkronach,50.0098461,11.6870938
28.74,3515,1763,1752,122,Ulmen,50.2082684,6.979957
9.7,3505,1753,1752,361,Owen,48.5876323,9.4506904
12.93,3500,1672,1828,271,Lucka,51.0951,12.3353
20.68,3491,1765,1726,169,Wildenfels,50.6660384,12.6090525
89.2,3481,1729,1752,39,Mühlberg/Elbe,51.4344274,13.2172472
75.87,3477,1680,1797,46,Neustadt (Dosse),52.8550517,12.440522
30.85,3473,1702,1771,113,Hirschhorn (Neckar),49.461,8.8974
9.01,3466,1637,1829,385,Stromberg,49.9447973,7.7763627
42.3,3464,1717,1747,82,Burgbernheim,49.4513351,10.3229575
14.07,3459,1687,1772,246,Gößnitz,50.889108,12.431532
27.77,3457,1643,1814,124,Münstermaifeld,50.2470805,7.3632746
87.36,3443,1708,1735,39,Krakow am See,53.6499594,12.266794
23.46,3436,1713,1723,146,Löwenstein,49.0953123,9.3809489
121.68,3430,1731,1699,28,Joachimsthal,52.9770643,13.7453282
46.78,3409,1671,1738,73,Bad Schandau,50.918091,14.1534018
87.35,3389,1689,1700,39,Tanna,50.4896337,11.860657
64.72,3372,1627,1745,52,Goldberg,53.5902655,12.0883101
8.16,3370,1695,1675,413,Oberriexingen,48.9274282,9.0292153
40.85,3358,1660,1698,82,Ostheim v.d.Rhön,50.4602714,10.2330495
25.98,3355,1623,1732,129,Schwarzatal,50.5867399,11.1256048
55.91,3332,1655,1677,60,Auma-Weidatal,50.7082198,11.9177098
66.67,3328,1685,1643,50,Rötz,49.341854,12.5319894
112.74,3322,1698,1624,29,Heldburg,50.2808914,10.7448265
18.56,3317,1591,1726,179,Geyer,50.623596,12.9249831
58.74,3315,1622,1693,56,Ludwigsstadt,50.4842311,11.3895014
72.05,3292,1621,1671,46,Saalburg-Ebersdorf,50.4948382,11.7074088
44.45,3271,1648,1623,74,Warin,53.7998004,11.7043569
8.18,3267,1582,1685,399,Kaisersesch,50.2307994,7.1404855
23.1,3266,1634,1632,141,Kranichfeld,50.8526515,11.1998899
25.17,3241,1669,1572,129,Bad Teinach-Zavelstein,48.6960311,8.6779546
20.62,3230,1599,1631,157,Hillesheim,50.2916705,6.6680009
39.57,3229,1588,1641,82,Welzow/Wjelcej,51.5837853,14.1706028
48.87,3229,1661,1568,66,Prichsenstadt,49.8176245,10.3530648
25.47,3221,1540,1681,126,Wolframs-Eschenbach,49.2264994,10.725877
81.97,3212,1610,1602,39,Havelsee,52.4913976,12.4595798
40.82,3199,1574,1625,78,Kelbra (Kyffhäuser),51.4358193,11.041443
44.02,3199,1597,1602,73,Schalkau,50.3938435,11.0056482
29.33,3195,1557,1638,109,Egeln,51.9400891,11.4273755
43.52,3193,1584,1609,73,Berga/Elster,50.7535905,12.1462645
64.64,3183,1592,1591,49,Hohnstein,50.9797836,14.1111221
39.8,3183,1591,1592,80,Stadtsteinach,50.1616746,11.5055461
119.29,3182,1610,1572,27,Sonnewalde,51.6950885,13.6451223
18.72,3173,1550,1623,169,Lauscha,50.4750346,11.1610862
52.0,3173,1596,1577,61,Bernstadt a. d. Eigen,51.0474279,14.8269241
22.91,3169,1573,1596,138,Neusalza-Spremberg,51.0337401,14.5444692
19.19,3165,1517,1648,165,Schönwald,50.1981219,12.0907653
22.47,3161,1583,1578,141,Fridingen an der Donau,48.0202558,8.9313419
48.48,3144,1550,1594,65,Kirchenlamitz,50.1515445,11.9502926
54.42,3142,1563,1579,58,Lebus,52.4271025,14.5338189
111.98,3139,1522,1617,28,Lychen,53.2083284,13.3164795
7.07,3135,1493,1642,443,Eibelstadt,49.7243433,10.0002727
44.44,3128,1466,1662,70,Klütz,53.9668696,11.1656678
15.79,3118,1505,1613,197,Döbern/Derbno,51.6147262,14.5972172
79.91,3114,1537,1577,39,Kirtorf,50.7683479,9.1061031
57.93,3104,1622,1482,54,Waischenfeld,49.8465726,11.345002
26.07,3083,1561,1522,118,Merkendorf,49.203735,10.7018353
74.41,3077,1608,1469,41,Bärnau,49.8109931,12.4304633
27.19,3070,1516,1554,113,Bürgel,50.9424523,11.7574105
50.96,3068,1552,1516,60,Weißenberg / Wóspork,51.1968328,14.658726
25.46,3067,1499,1568,120,Nebra (Unstrut),51.2873083,11.5787877
31.54,3040,1556,1484,96,Waldenburg,50.8743975,12.6003812
42.23,3031,1516,1515,72,Weißenstadt,50.1014733,11.8847041
16.31,3031,1474,1557,186,Rhens,50.281527,7.6162978
89.65,3029,1503,1526,34,Wesenberg,53.2819098,12.9694804
65.61,3019,1501,1518,46,Ulrichstein,50.5759667,9.1929639
8.7,3014,1475,1539,346,Selters (Westerwald),50.5203849,7.7337742
58.51,3000,1490,1510,51,Hatzfeld (Eder),50.9847904,8.5630273
174.15,2985,1513,1472,17,Friedland,53.6716022,13.5487647
156.16,2973,1508,1465,19,Schönewalde,51.8142338,13.2279131
48.88,2970,1448,1522,61,Liebenau,51.4773742,9.2769625
19.5,2969,1495,1474,152,Braubach,50.2751222,7.651073
55.04,2969,1437,1532,54,Schöneck/Vogtl.,50.3875211,12.3413148
60.57,2967,1477,1490,49,Dömitz,53.1384884,11.2609279
55.97,2958,1519,1439,53,Ravenstein,49.4086836,9.5343732
57.65,2955,1489,1466,51,Gützkow,53.9378689,13.4100305
65.47,2941,1500,1441,45,Lindow (Mark),52.9744071,12.9872378
72.32,2940,1473,1467,41,Wurzbach,50.4637381,11.5372317
18.56,2916,1447,1469,157,Adenau,50.3823283,6.9304002
23.17,2913,1461,1452,126,Sankt Goar,50.15,7.71667
15.45,2902,1416,1486,188,Münchenbernsdorf,50.8206082,11.9330185
18.08,2899,1423,1476,160,Oberwesel,50.1075,7.7266193
57.29,2886,1424,1462,50,Frankenau,51.1068994,8.9274787
35.48,2878,1401,1477,81,Marktleuthen,50.1279651,11.9945062
41.11,2867,1391,1476,70,Gnoien,53.9703915,12.7054032
30.71,2846,1405,1441,93,Jarmen,53.9221033,13.3374416
10.33,2836,1370,1466,275,Meisenheim,49.706647,7.6700779
3.06,2814,1360,1454,920,Garding,54.3295733,8.7793889
27.5,2805,1438,1367,102,Schillingsfürst,49.2867655,10.260648
22.74,2769,1324,1445,122,Sulzburg,47.8405127,7.7077606
31.28,2768,1416,1352,88,Laucha an der Unstrut,51.2233104,11.682231
45.74,2749,1356,1393,60,Elterlein,50.5769435,12.8688973
30.18,2748,1366,1382,91,Wustrow (Wendland),52.9233083,11.12666
20.18,2739,1360,1379,136,Themar,50.5033487,10.6150564
44.54,2730,1378,1352,61,Ebeleben,51.2827699,10.7302423
32.63,2697,1374,1323,83,Elstra / Halštrow,51.220516,14.1350305
54.97,2694,1365,1329,49,Tribsees,54.0946272,12.7584066
58.98,2690,1351,1339,46,Frauenstein,50.8024134,13.5382248
54.43,2690,1294,1396,49,Romrod,50.7145631,9.2188198
27.22,2620,1301,1319,96,Brüel,53.7344671,11.7158035
49.93,2602,1314,1288,52,Bad Bibra,51.2064665,11.5835806
53.43,2592,1345,1247,49,Schkölen,51.0408527,11.821197
119.68,2589,1310,1279,22,Putlitz,53.2505941,12.0409827
23.31,2587,1287,1300,111,Lauterstein,48.7109286,9.8762584
79.38,2577,1223,1354,32,Bad Wilsnack,52.9556782,11.9448627
45.65,2566,1284,1282,56,Wallenfels,50.2691372,11.4701616
84.03,2555,1286,1269,30,Friesack,52.7395263,12.5782641
4.02,2544,1196,1348,633,Friedrichstadt,54.3760004,9.0897716
18.73,2535,1287,1248,135,Scheer,48.0731597,9.2965371
51.84,2515,1276,1239,49,Betzenstein,49.6808025,11.4177797
35.52,2514,1278,1236,71,Rastenberg,51.1761837,11.4211488
27.42,2497,1229,1268,91,Bad Tennstedt,51.1540155,10.8369361
23.72,2494,1157,1337,105,Alsleben (Saale),51.7041882,11.6766954
67.96,2493,1222,1271,37,Ziesar,52.2652873,12.2898896
49.69,2493,1267,1226,50,Jöhstadt,50.5142346,13.0900195
63.66,2489,1253,1236,39,Golßen,51.9709352,13.6045078
14.72,2450,1221,1229,166,Schönau im Schwarzwald,47.7861792,7.8933977
32.97,2437,1184,1253,74,Schwanebeck,51.9601208,11.1169263
3.38,2429,1218,1211,719,Krempe,53.8360392,9.489977
10.68,2427,1227,1200,227,Aach,49.7894542,6.5906612
61.88,2427,1204,1223,39,Gartz (Oder),53.208577,14.3914352
27.66,2399,1239,1160,87,Osterfeld,51.0806259,11.9305596
78.65,2394,1168,1226,30,Schlieben,51.7241402,13.3847709
45.22,2390,1204,1186,53,Gefell,50.2385151,6.9115834
34.08,2387,1209,1178,70,Rethem (Aller),52.7834554,9.3780422
51.88,2382,1202,1180,46,Wegeleben,51.8848859,11.1731482
55.34,2382,1189,1193,43,Grebenau,50.7302717,9.4369168
50.28,2360,1202,1158,47,Schönsee,49.5102734,12.5466459
42.4,2351,1168,1183,55,Pleystein,49.6459255,12.4099793
12.21,2334,1163,1171,191,Mainbernheim,49.7087639,10.2177792
30.44,2319,1151,1168,76,Dommitzsch,51.6401155,12.8818456
9.18,2315,1083,1232,252,Katzenelnbogen,50.2676224,7.9768379
21.22,2272,1125,1147,107,Schlettau,50.5575902,12.9502234
36.13,2265,1144,1121,63,Eckartsberga,51.1231891,11.5604073
65.91,2256,1104,1152,34,Garz/Rügen,54.3195842,13.3516021
63.37,2256,1116,1140,36,Hayingen,48.2751679,9.4781135
23.48,2228,1102,1126,95,Ostritz,51.014934,14.9327975
46.34,2190,1119,1071,47,Fladungen,50.5210371,10.1458492
24.08,2187,1096,1091,91,Gebesee,51.1167,10.9333
34.22,2186,1048,1138,64,Rerik,54.1067652,11.6171165
24.13,2147,1087,1060,89,Hirschberg,50.3781716,7.9223613
27.05,2141,1084,1057,79,Königstein/Sächs. Schw.,50.9185261,14.0732271
31.25,2134,1056,1078,68,Veringenstadt,48.1842669,9.2087391
50.71,2129,1071,1058,42,Meyenburg,53.3140131,12.2426273
51.55,2111,1068,1043,41,Rosenthal,50.9860458,8.823919
36.12,2107,1080,1027,58,Oderberg,52.865906,14.0450286
96.2,2066,1009,1057,21,Lenzen (Elbe),53.0908005,11.4748618
45.11,2056,1045,1011,46,Niemegk,52.0749361,12.6889448
40.03,2051,1010,1041,51,Oberwiesenthal,50.4355522,12.9489367
8.89,2044,1005,1039,230,Lauterecken,49.6500535,7.5918264
23.41,2044,1047,997,87,Wiesensteig,48.5620891,9.6264045
7.36,2021,953,1068,275,Ortrand,51.3761283,13.7576971
9.0,2012,985,1027,224,Scheibenberg,50.5404022,12.9144207
57.52,2011,1008,1003,35,Leutenberg,50.5640756,11.4561656
22.69,1975,966,1009,87,Plaue,50.7776493,10.8980915
15.47,1973,999,974,128,Sachsenhagen,52.3966396,9.2663019
20.58,1972,987,985,96,Magdala,50.9065543,11.4463291
26.19,1941,954,987,74,Rieneck,50.0942383,9.6472187
34.25,1921,936,985,56,Teuschnitz,50.397541,11.380875
10.51,1920,1001,919,183,Marktsteft,49.696722,10.1350962
13.77,1908,966,942,139,Wolfstein,49.5829885,7.606534
26.66,1899,950,949,71,Schauenstein,50.2776388,11.7414272
48.16,1895,931,964,39,Teupitz,52.135986,13.6098424
31.4,1886,980,906,60,Langenburg,49.2531928,9.8477788
36.42,1869,928,941,51,Gräfenthal,50.525919,11.3058452
46.06,1859,944,915,40,Hettingen,48.2169103,9.2317078
23.35,1845,923,922,79,Bacharach,50.0597943,7.7683997
25.23,1836,961,875,73,Widdern,49.3180932,9.4217233
101.81,1835,946,889,18,Brüssow,53.3994602,14.126711
21.34,1808,918,890,85,Velden,49.6135225,11.5109171
26.67,1764,889,875,66,Bad Sülze,54.1119649,12.6581128
78.87,1756,868,888,22,Penkun,53.2977629,14.2413131
47.97,1753,879,874,37,Neukalen,53.8228766,12.7918145
39.06,1723,836,887,44,Usedom,53.9905064,14.0829451
35.3,1702,866,836,48,Sayda,50.7124239,13.4193688
15.16,1697,879,818,112,Ornbau,49.1741629,10.6560093
23.4,1681,840,841,72,Oberhof,50.7067756,10.7257435
27.21,1673,857,816,61,Röttingen,49.511308,9.970905
10.57,1660,807,853,157,Ranis,50.6638396,11.5675201
10.87,1604,843,761,148,Stadtprozelten,49.7809332,9.4053282
31.67,1584,775,809,50,Rhinow,52.7508589,12.3410614
10.17,1560,790,770,153,Neuerburg,50.0107307,6.2947705
35.94,1555,810,745,43,Lehesten,50.98187,11.5795506
10.85,1543,788,755,142,Stadt Wehlen,50.957091,14.0307534
14.42,1493,729,764,104,Buckow (Märkische Schweiz),52.5672167,14.0761529
28.21,1473,733,740,52,Lassan,53.9486928,13.8490767
10.06,1462,694,768,145,Manderscheid,50.10047,6.3463431
31.14,1443,706,737,46,Arneburg,52.674454,12.0035022
15.66,1438,709,729,92,Hohenberg a.d.Eger,50.0970494,12.2232841
9.53,1426,798,628,150,Hohenleuben,50.7103628,12.0519044
13.34,1419,710,709,106,Hornbach,49.1875373,7.3687796
17.54,1398,733,665,80,Aub,49.5524989,10.0652861
38.91,1377,684,693,35,Kroppenstedt,51.9416648,11.3085172
15.67,1365,677,688,87,Richtenberg,54.2007307,12.8857023
15.2,1353,656,697,89,Franzburg,54.1871931,12.878125
73.03,1338,670,668,18,Lieberose,51.9865536,14.2996945
7.06,1281,653,628,181,Sankt Goarshausen,50.1548796,7.7160976
37.36,1248,642,606,33,Liebstadt,50.8634629,13.8570413
26.9,1194,653,541,44,Schwarzenborn,50.0390136,6.7113515
20.3,1145,568,577,56,Neustadt am Kulm,49.8256936,11.835319
8.28,1070,544,526,129,Kupferberg,50.1391777,11.5766311
7.07,1066,525,541,151,Schraplau,51.4383844,11.6668362
7.47,1063,540,523,142,Orlamünde,50.7753002,11.5202176
10.15,1054,521,533,104,Obermoschel,49.7268361,7.7719699
10.75,1037,507,530,96,Clingen,51.2346746,10.9293611
9.47,1026,504,522,108,Lichtenberg,52.5321606,13.5118927
12.07,1022,517,505,85,Rothenfels,49.8912549,9.5919615
4.62,958,500,458,207,Kyllburg,50.041096,6.5922224
53.2,933,484,449,18,Werben (Elbe),52.8612295,11.9822053
7.33,889,427,462,121,Stößen,51.1142361,11.9237845
24.86,885,453,432,36,Märkisch Buchholz,52.110158,13.7628126
18.56,831,393,438,45,Sandau (Elbe),52.7890696,12.0480053
13.05,786,402,384,60,Kaub,50.0880512,7.7620909
8.25,615,303,312,75,Ziegenrück,50.6143209,11.6507127
23.7,521,259,262,22,Schnackenburg,53.036474,11.5644762
8.67,482,253,229,56,Neumark,51.0789637,11.2459719
15.73,463,237,226,29,Ummerstadt,50.2593342,10.8116591
0.45,254,125,129,564,Arnis,54.63008,9.9327513
